MaliciousReporter:  , M_LL_0 , 1 , -1 ,  41 , 1 , 40
MaliciousReporter:  , M_LL_1 , 2 , -1 ,  55 , 1 , 54
MaliciousReporter:  , M_LL_2 , 3 , -1 ,  36 , 0 , 36
MaliciousReporter:  , M_LL_3 , 4 , -1 ,  47 , 4 , 43
MaliciousReporter:  , M_LL_4 , 5 , -1 ,  60 , 3 , 57
MaliciousReporter:  , M_LL_5 , 6 , -1 ,  55 , 1 , 54
MaliciousReporter:  , M_LL_6 , 7 , -1 ,  37 , 0 , 37
MaliciousReporter:  , M_LL_7 , 8 , -1 ,  34 , 1 , 33
MaliciousReporter:  , M_LL_8 , 9 , -1 ,  55 , 2 , 53
MaliciousReporter:  , M_LL_9 , 10 , -1 ,  57 , 1 , 56
MaliciousReporter:  , M_LL_10 , 11 , -1 ,  28 , 2 , 26
MaliciousReporter:  , M_LL_11 , 12 , -1 ,  39 , 2 , 37
MaliciousReporter:  , M_LL_12 , 13 , -1 ,  55 , 2 , 53
MaliciousReporter:  , M_LL_13 , 14 , -1 ,  34 , 2 , 32
MaliciousReporter:  , M_LL_14 , 15 , -1 ,  56 , 4 , 52
MaliciousReporter:  , M_LL_15 , 16 , -1 ,  34 , 2 , 32
MaliciousReporter:  , M_LL_16 , 17 , -1 ,  35 , 1 , 34
MaliciousReporter:  , M_LL_17 , 18 , -1 ,  57 , 7 , 50
MaliciousReporter:  , M_LL_18 , 19 , -1 ,  51 , 4 , 47
MaliciousReporter:  , M_LL_19 , 20 , -1 ,  50 , 1 , 49
MaliciousReporter:  , M_LL_20 , 21 , -1 ,  45 , 0 , 45
MaliciousReporter:  , M_LL_21 , 22 , -1 ,  38 , 1 , 37
MaliciousReporter:  , M_LL_22 , 23 , -1 ,  62 , 4 , 58
MaliciousReporter:  , M_LL_23 , 24 , -1 ,  32 , 1 , 31
MaliciousReporter:  , M_LL_24 , 25 , -1 ,  36 , 0 , 36
MaliciousReporter:  , M_LL_25 , 26 , -1 ,  40 , 0 , 40
MaliciousReporter:  , M_LL_26 , 27 , -1 ,  48 , 2 , 46
MaliciousReporter:  , M_LL_27 , 28 , -1 ,  50 , 3 , 47
MaliciousReporter:  , M_LL_28 , 29 , -1 ,  29 , 1 , 28
MaliciousReporter:  , M_LL_29 , 30 , -1 ,  57 , 5 , 52
MaliciousReporter:  , M_LR_300 , 31 , -0.963939 ,  3 , 0 , 3
MaliciousReporter:  , M_LR_302 , 32 , -1 ,  19 , 0 , 19
MaliciousReporter:  , M_LR_304 , 33 , -1 ,  22 , 2 , 20
MaliciousReporter:  , M_LR_305 , 34 , -0.99017 ,  4 , 0 , 4
MaliciousReporter:  , M_LR_306 , 35 , -1 ,  44 , 7 , 37
MaliciousReporter:  , M_LR_308 , 36 , -0.999997 ,  12 , 1 , 11
MaliciousReporter:  , M_LR_309 , 37 , -0.999818 ,  7 , 0 , 7
MaliciousReporter:  , M_LR_310 , 38 , -0.999997 ,  10 , 0 , 10
MaliciousReporter:  , M_LR_311 , 39 , -1 ,  18 , 1 , 17
MaliciousReporter:  , M_LR_312 , 40 , -0.999987 ,  13 , 2 , 11
MaliciousReporter:  , M_LR_313 , 41 , -0.963541 ,  3 , 0 , 3
MaliciousReporter:  , M_LR_314 , 42 , -1 ,  13 , 0 , 13
MaliciousReporter:  , M_LR_315 , 43 , -1 ,  23 , 1 , 22
MaliciousReporter:  , M_LR_317 , 44 , -1 ,  17 , 0 , 17
MaliciousReporter:  , M_LR_318 , 45 , -0.999997 ,  10 , 0 , 10
MaliciousReporter:  , M_LR_319 , 46 , -1 ,  12 , 0 , 12
MaliciousReporter:  , M_LR_320 , 47 , -0.871352 ,  2 , 0 , 2
MaliciousReporter:  , M_LR_321 , 48 , -1 ,  15 , 0 , 15
MaliciousReporter:  , M_LR_322 , 49 , -1 ,  38 , 3 , 35
MaliciousReporter:  , M_LR_324 , 50 , -1 ,  20 , 1 , 19
MaliciousReporter:  , M_LR_325 , 51 , -0.608815 ,  1 , 0 , 1
MaliciousReporter:  , M_LR_327 , 52 , -1 ,  16 , 0 , 16
MaliciousReporter:  , M_LR_328 , 53 , -1 ,  23 , 0 , 23
MaliciousReporter:  , M_LR_329 , 54 , -1 ,  38 , 4 , 34
MaliciousReporter:  , M_UL_600 , 55 , -1 ,  28 , 4 , 24
MaliciousReporter:  , M_UL_601 , 56 , -1 ,  18 , 1 , 17
MaliciousReporter:  , M_UL_602 , 57 , -1 ,  16 , 1 , 15
MaliciousReporter:  , M_UL_603 , 58 , -1 ,  17 , 1 , 16
MaliciousReporter:  , M_UL_605 , 59 , -0.999316 ,  12 , 3 , 9
MaliciousReporter:  , M_UL_607 , 60 , -1 ,  30 , 0 , 30
MaliciousReporter:  , M_UL_608 , 61 , -1 ,  38 , 2 , 36
MaliciousReporter:  , M_UL_609 , 62 , -1 ,  34 , 2 , 32
MaliciousReporter:  , M_UL_611 , 63 , -0.997404 ,  5 , 0 , 5
MaliciousReporter:  , M_UL_612 , 64 , -1 ,  15 , 0 , 15
MaliciousReporter:  , M_UL_613 , 65 , -0.999987 ,  11 , 1 , 10
MaliciousReporter:  , M_UL_614 , 66 , -0.999312 ,  6 , 0 , 6
MaliciousReporter:  , M_UL_615 , 67 , -0.999987 ,  9 , 0 , 9
MaliciousReporter:  , M_UL_616 , 68 , -0.872685 ,  2 , 0 , 2
MaliciousReporter:  , M_UL_617 , 69 , -1 ,  26 , 3 , 23
MaliciousReporter:  , M_UL_618 , 70 , -1 ,  23 , 1 , 22
MaliciousReporter:  , M_UL_619 , 71 , -1 ,  32 , 2 , 30
MaliciousReporter:  , M_UL_621 , 72 , -0.963633 ,  3 , 0 , 3
MaliciousReporter:  , M_UL_622 , 73 , -0.999951 ,  8 , 0 , 8
MaliciousReporter:  , M_UL_623 , 74 , -1 ,  28 , 2 , 26
MaliciousReporter:  , M_UL_624 , 75 , -1 ,  19 , 1 , 18
MaliciousReporter:  , M_UL_625 , 76 , -0.609043 ,  1 , 0 , 1
MaliciousReporter:  , M_UL_626 , 77 , -1 ,  17 , 1 , 16
MaliciousReporter:  , M_UL_629 , 78 , -0.999314 ,  6 , 0 , 6
MaliciousReporter:  , M_UR_901 , 79 , -0.868807 ,  4 , 1 , 3
MaliciousReporter:  , M_UR_902 , 80 , -0.997388 ,  5 , 0 , 5
MaliciousReporter:  , M_UR_903 , 81 , 0.000493142 ,  2 , 1 , 1
MaliciousReporter:  , M_UR_905 , 82 , -0.610127 ,  1 , 0 , 1
MaliciousReporter:  , M_UR_906 , 83 , -1 ,  25 , 3 , 22
MaliciousReporter:  , M_UR_908 , 84 , -1 ,  23 , 1 , 22
MaliciousReporter:  , M_UR_912 , 85 , -0.609948 ,  1 , 0 , 1
MaliciousReporter:  , M_UR_913 , 86 , -0.963223 ,  7 , 2 , 5
MaliciousReporter:  , M_UR_917 , 87 , -0.86952 ,  4 , 1 , 3
MaliciousReporter:  , M_UR_918 , 88 , -1 ,  16 , 0 , 16
MaliciousReporter:  , M_UR_920 , 89 , -0.609948 ,  1 , 0 , 1
MaliciousReporter:  , M_UR_921 , 90 , -0.963608 ,  3 , 0 , 3
MaliciousReporter:  , M_UR_924 , 91 , -0.868365 ,  4 , 1 , 3
MaliciousReporter:  , M_UR_925 , 92 , 0 ,  2 , 1 , 1
MaliciousReporter:  , M_UR_927 , 93 , -1 ,  15 , 1 , 14
MaliciousReporter:  , M_UR_928 , 94 , -0.868494 ,  4 , 1 , 3
SelfishReporter:  , S_LL_30 , 95 , 0.965192 , 38 ,  21 , 17
SelfishReporter:  , S_LL_31 , 96 , 1 , 60 ,  37 , 23
SelfishReporter:  , S_LL_32 , 97 , -0.58692 , 32 ,  16 , 16
SelfishReporter:  , S_LL_33 , 98 , -0.999998 , 34 ,  12 , 22
SelfishReporter:  , S_LL_34 , 99 , 0.999852 , 76 ,  43 , 33
SelfishReporter:  , S_LL_35 , 100 , 1 , 45 ,  29 , 16
SelfishReporter:  , S_LL_36 , 101 , 0.992083 , 62 ,  34 , 28
SelfishReporter:  , S_LL_37 , 102 , -0.305146 , 57 ,  29 , 28
SelfishReporter:  , S_LL_38 , 103 , 0.999915 , 82 ,  46 , 36
SelfishReporter:  , S_LL_39 , 104 , 0.635504 , 41 ,  22 , 19
SelfishReporter:  , S_LL_40 , 105 , 0.98984 , 20 ,  12 , 8
SelfishReporter:  , S_LL_41 , 106 , 0.999158 , 68 ,  38 , 30
SelfishReporter:  , S_LL_42 , 107 , 0.999986 , 25 ,  17 , 8
SelfishReporter:  , S_LL_43 , 108 , 1 , 58 ,  34 , 24
SelfishReporter:  , S_LL_44 , 109 , 1 , 46 ,  29 , 17
SelfishReporter:  , S_LL_45 , 110 , 0.999999 , 54 ,  33 , 21
SelfishReporter:  , S_LL_46 , 111 , 0.999886 , 26 ,  17 , 9
SelfishReporter:  , S_LL_47 , 112 , 0.999412 , 66 ,  37 , 29
SelfishReporter:  , S_LL_48 , 113 , -0.999811 , 47 ,  21 , 26
SelfishReporter:  , S_LL_49 , 114 , 0.999131 , 51 ,  29 , 22
SelfishReporter:  , S_LL_50 , 115 , -0.0070162 , 10 ,  5 , 5
SelfishReporter:  , S_LL_51 , 116 , 1 , 63 ,  39 , 24
SelfishReporter:  , S_LL_52 , 117 , -0.697929 , 61 ,  31 , 30
SelfishReporter:  , S_LL_53 , 118 , 1 , 43 ,  29 , 14
SelfishReporter:  , S_LL_54 , 119 , 0.962355 , 25 ,  14 , 11
SelfishReporter:  , S_LL_55 , 120 , 0.336518 , 44 ,  23 , 21
SelfishReporter:  , S_LL_56 , 121 , 0.999999 , 44 ,  28 , 16
SelfishReporter:  , S_LL_57 , 122 , 0.777716 , 30 ,  16 , 14
SelfishReporter:  , S_LL_58 , 123 , 0.998239 , 34 ,  20 , 14
SelfishReporter:  , S_LL_59 , 124 , 0.997963 , 57 ,  32 , 25
SelfishReporter:  , S_LL_60 , 125 , 1 , 64 ,  39 , 25
SelfishReporter:  , S_LL_61 , 126 , 0.37089 , 39 ,  20 , 19
SelfishReporter:  , S_LL_62 , 127 , 0.988829 , 45 ,  25 , 20
SelfishReporter:  , S_LL_63 , 128 , 0.99785 , 62 ,  35 , 27
SelfishReporter:  , S_LL_64 , 129 , -0.99777 , 38 ,  17 , 21
SelfishReporter:  , S_LL_65 , 130 , 0.83458 , 57 ,  30 , 27
SelfishReporter:  , S_LL_66 , 131 , 0.998984 , 51 ,  29 , 22
SelfishReporter:  , S_LL_67 , 132 , 0.997905 , 53 ,  30 , 23
SelfishReporter:  , S_LL_68 , 133 , 0.827506 , 24 ,  13 , 11
SelfishReporter:  , S_LL_69 , 134 , -0.573683 , 46 ,  23 , 23
SelfishReporter:  , S_LL_70 , 135 , 0.650449 , 36 ,  19 , 17
SelfishReporter:  , S_LL_71 , 136 , 0.931311 , 56 ,  30 , 26
SelfishReporter:  , S_LL_72 , 137 , 0.99874 , 30 ,  18 , 12
SelfishReporter:  , S_LL_73 , 138 , 0.999554 , 50 ,  29 , 21
SelfishReporter:  , S_LL_74 , 139 , -0.999942 , 63 ,  28 , 35
SelfishReporter:  , S_LL_75 , 140 , 1 , 62 ,  43 , 19
SelfishReporter:  , S_LL_76 , 141 , -0.90058 , 16 ,  7 , 9
SelfishReporter:  , S_LL_77 , 142 , 0.188311 , 65 ,  34 , 31
SelfishReporter:  , S_LL_78 , 143 , 0.729666 , 51 ,  27 , 24
SelfishReporter:  , S_LL_79 , 144 , 0.999127 , 60 ,  34 , 26
SelfishReporter:  , S_LL_80 , 145 , 0.16195 , 72 ,  37 , 35
SelfishReporter:  , S_LL_81 , 146 , 1 , 46 ,  31 , 15
SelfishReporter:  , S_LL_82 , 147 , 0.0623169 , 37 ,  19 , 18
SelfishReporter:  , S_LL_83 , 148 , 0.996214 , 60 ,  33 , 27
SelfishReporter:  , S_LL_84 , 149 , 0.999976 , 77 ,  44 , 33
SelfishReporter:  , S_LL_85 , 150 , 0.986224 , 28 ,  16 , 12
SelfishReporter:  , S_LL_86 , 151 , 0.999216 , 68 ,  38 , 30
SelfishReporter:  , S_LL_87 , 152 , 0.999562 , 31 ,  19 , 12
SelfishReporter:  , S_LL_88 , 153 , 0.999855 , 70 ,  40 , 30
SelfishReporter:  , S_LL_89 , 154 , -0.929707 , 54 ,  27 , 27
SelfishReporter:  , S_LR_330 , 155 , -0.595126 , 34 ,  17 , 17
SelfishReporter:  , S_LR_331 , 156 , -0.868692 , 8 ,  3 , 5
SelfishReporter:  , S_LR_332 , 157 , 0.0080015 , 8 ,  4 , 4
SelfishReporter:  , S_LR_333 , 158 , -0.997387 , 7 ,  1 , 6
SelfishReporter:  , S_LR_335 , 159 , 0.00300919 , 6 ,  3 , 3
SelfishReporter:  , S_LR_337 , 160 , -0.990306 , 28 ,  12 , 16
SelfishReporter:  , S_LR_338 , 161 , 0.00333361 , 2 ,  1 , 1
SelfishReporter:  , S_LR_339 , 162 , -0.585602 , 3 ,  1 , 2
SelfishReporter:  , S_LR_340 , 163 , 0.894136 , 37 ,  20 , 17
SelfishReporter:  , S_LR_341 , 164 , -0.60989 , 1 ,  0 , 1
SelfishReporter:  , S_LR_342 , 165 , -0.608815 , 1 ,  0 , 1
SelfishReporter:  , S_LR_343 , 166 , 0.58279 , 7 ,  4 , 3
SelfishReporter:  , S_LR_344 , 167 , 0.61126 , 1 ,  1 , 0
SelfishReporter:  , S_LR_346 , 168 , -0.872121 , 20 ,  9 , 11
SelfishReporter:  , S_LR_348 , 169 , -0.867451 , 16 ,  7 , 9
SelfishReporter:  , S_LR_350 , 170 , -0.870029 , 8 ,  3 , 5
SelfishReporter:  , S_LR_352 , 171 , 0.579979 , 5 ,  3 , 2
SelfishReporter:  , S_LR_354 , 172 , 0.0123331 , 12 ,  6 , 6
SelfishReporter:  , S_LR_355 , 173 , -0.997348 , 13 ,  4 , 9
SelfishReporter:  , S_LR_357 , 174 , 0.578528 , 3 ,  2 , 1
SelfishReporter:  , S_LR_358 , 175 , 0.999816 , 17 ,  12 , 5
SelfishReporter:  , S_LR_359 , 176 , -0.92248 , 26 ,  12 , 14
SelfishReporter:  , S_LR_360 , 177 , -0.67336 , 19 ,  9 , 10
SelfishReporter:  , S_LR_363 , 178 , -0.577087 , 9 ,  4 , 5
SelfishReporter:  , S_LR_364 , 179 , 0.581742 , 17 ,  9 , 8
SelfishReporter:  , S_LR_365 , 180 , 0.61126 , 1 ,  1 , 0
SelfishReporter:  , S_LR_366 , 181 , 0.999319 , 16 ,  11 , 5
SelfishReporter:  , S_LR_367 , 182 , 0.997371 , 31 ,  18 , 13
SelfishReporter:  , S_LR_368 , 183 , 0.872503 , 2 ,  2 , 0
SelfishReporter:  , S_LR_370 , 184 , 0.582071 , 7 ,  4 , 3
SelfishReporter:  , S_LR_371 , 185 , 0.869211 , 38 ,  20 , 18
SelfishReporter:  , S_LR_373 , 186 , 0.584834 , 5 ,  3 , 2
SelfishReporter:  , S_LR_375 , 187 , -0.58606 , 7 ,  3 , 4
SelfishReporter:  , S_LR_376 , 188 , 0.610966 , 1 ,  1 , 0
SelfishReporter:  , S_LR_377 , 189 , -0.581275 , 11 ,  5 , 6
SelfishReporter:  , S_LR_378 , 190 , -0.580001 , 3 ,  1 , 2
SelfishReporter:  , S_LR_380 , 191 , -0.582258 , 13 ,  6 , 7
SelfishReporter:  , S_LR_381 , 192 , -0.869248 , 4 ,  1 , 3
SelfishReporter:  , S_LR_382 , 193 , -0.576493 , 17 ,  8 , 9
SelfishReporter:  , S_LR_383 , 194 , -0.61126 , 1 ,  0 , 1
SelfishReporter:  , S_LR_384 , 195 , 0.870134 , 26 ,  14 , 12
SelfishReporter:  , S_LR_385 , 196 , -0.608815 , 1 ,  0 , 1
SelfishReporter:  , S_LR_386 , 197 , -0.867334 , 8 ,  3 , 5
SelfishReporter:  , S_LR_388 , 198 , 0.0057126 , 6 ,  3 , 3
SelfishReporter:  , S_UL_630 , 199 , -0.867227 , 22 ,  10 , 12
SelfishReporter:  , S_UL_631 , 200 , 0.964627 , 11 ,  7 , 4
SelfishReporter:  , S_UL_632 , 201 , 0.996494 , 41 ,  23 , 18
SelfishReporter:  , S_UL_633 , 202 , 0.990089 , 14 ,  9 , 5
SelfishReporter:  , S_UL_637 , 203 , 0.963983 , 25 ,  14 , 11
SelfishReporter:  , S_UL_640 , 204 , 0.870375 , 4 ,  3 , 1
SelfishReporter:  , S_UL_641 , 205 , -0.869333 , 14 ,  6 , 8
SelfishReporter:  , S_UL_643 , 206 , 0.0012189 , 4 ,  2 , 2
SelfishReporter:  , S_UL_644 , 207 , 0.999818 , 35 ,  21 , 14
SelfishReporter:  , S_UL_645 , 208 , 0.999987 , 19 ,  14 , 5
SelfishReporter:  , S_UL_646 , 209 , -0.990269 , 14 ,  5 , 9
SelfishReporter:  , S_UL_648 , 210 , -0.585694 , 21 ,  10 , 11
SelfishReporter:  , S_UL_652 , 211 , 0.609694 , 1 ,  1 , 0
SelfishReporter:  , S_UL_653 , 212 , 0.612903 , 1 ,  1 , 0
SelfishReporter:  , S_UL_654 , 213 , 0.000322399 , 12 ,  6 , 6
SelfishReporter:  , S_UL_655 , 214 , -0.585088 , 11 ,  5 , 6
SelfishReporter:  , S_UL_656 , 215 , -0.578928 , 3 ,  1 , 2
SelfishReporter:  , S_UL_657 , 216 , 0.96391 , 3 ,  3 , 0
SelfishReporter:  , S_UL_659 , 217 , 0.999308 , 14 ,  10 , 4
SelfishReporter:  , S_UL_662 , 218 , 0.99931 , 20 ,  13 , 7
SelfishReporter:  , S_UL_663 , 219 , 0.999999 , 27 ,  19 , 8
SelfishReporter:  , S_UL_664 , 220 , -0.609043 , 1 ,  0 , 1
SelfishReporter:  , S_UL_665 , 221 , 0.578598 , 7 ,  4 , 3
SelfishReporter:  , S_UL_668 , 222 , 0.999999 , 31 ,  21 , 10
SelfishReporter:  , S_UL_669 , 223 , -0.610811 , 1 ,  0 , 1
SelfishReporter:  , S_UL_670 , 224 , 1 , 37 ,  25 , 12
SelfishReporter:  , S_UL_671 , 225 , 0.00173455 , 6 ,  3 , 3
SelfishReporter:  , S_UL_673 , 226 , -0.00319735 , 6 ,  3 , 3
SelfishReporter:  , S_UL_674 , 227 , -0.868838 , 14 ,  6 , 8
SelfishReporter:  , S_UL_677 , 228 , 0.999821 , 23 ,  15 , 8
SelfishReporter:  , S_UL_678 , 229 , 0.000848176 , 2 ,  1 , 1
SelfishReporter:  , S_UL_679 , 230 , 0.999999 , 37 ,  24 , 13
SelfishReporter:  , S_UL_680 , 231 , 0.000701094 , 2 ,  1 , 1
SelfishReporter:  , S_UL_684 , 232 , 0.999999 , 47 ,  29 , 18
SelfishReporter:  , S_UL_686 , 233 , 0.585391 , 3 ,  2 , 1
SelfishReporter:  , S_UL_688 , 234 , 0.999323 , 30 ,  18 , 12
SelfishReporter:  , S_UL_689 , 235 , 0.999999 , 31 ,  21 , 10
SelfishReporter:  , S_UR_931 , 236 , 0.61039 , 1 ,  1 , 0
SelfishReporter:  , S_UR_935 , 237 , 0.869412 , 4 ,  3 , 1
SelfishReporter:  , S_UR_936 , 238 , 0.583021 , 3 ,  2 , 1
SelfishReporter:  , S_UR_938 , 239 , 0.609694 , 1 ,  1 , 0
SelfishReporter:  , S_UR_940 , 240 , -0.609948 , 1 ,  0 , 1
SelfishReporter:  , S_UR_942 , 241 , 0.99738 , 13 ,  9 , 4
SelfishReporter:  , S_UR_944 , 242 , 0.00234943 , 12 ,  6 , 6
SelfishReporter:  , S_UR_949 , 243 , 0.990312 , 12 ,  8 , 4
SelfishReporter:  , S_UR_950 , 244 , -0.609948 , 1 ,  0 , 1
SelfishReporter:  , S_UR_951 , 245 , -0.609948 , 1 ,  0 , 1
SelfishReporter:  , S_UR_952 , 246 , 0.609948 , 1 ,  1 , 0
SelfishReporter:  , S_UR_957 , 247 , 0.999997 , 22 ,  16 , 6
SelfishReporter:  , S_UR_958 , 248 , -0.00616647 , 10 ,  5 , 5
SelfishReporter:  , S_UR_959 , 249 , 0.999987 , 25 ,  17 , 8
SelfishReporter:  , S_UR_961 , 250 , 0.999817 , 11 ,  9 , 2
SelfishReporter:  , S_UR_962 , 251 , -0.609948 , 1 ,  0 , 1
SelfishReporter:  , S_UR_964 , 252 , 0.963806 , 3 ,  3 , 0
SelfishReporter:  , S_UR_965 , 253 , 0.583021 , 3 ,  2 , 1
SelfishReporter:  , S_UR_966 , 254 , 0.997336 , 13 ,  9 , 4
SelfishReporter:  , S_UR_967 , 255 , 0.000489792 , 4 ,  2 , 2
SelfishReporter:  , S_UR_969 , 256 , 0.000890213 , 2 ,  1 , 1
SelfishReporter:  , S_UR_971 , 257 , 0.963367 , 17 ,  10 , 7
SelfishReporter:  , S_UR_972 , 258 , 0.609948 , 1 ,  1 , 0
SelfishReporter:  , S_UR_973 , 259 , 0.58233 , 3 ,  2 , 1
SelfishReporter:  , S_UR_974 , 260 , 1 , 26 ,  19 , 7
SelfishReporter:  , S_UR_975 , 261 , -0.609948 , 1 ,  0 , 1
SelfishReporter:  , S_UR_976 , 262 , -0.609948 , 1 ,  0 , 1
SelfishReporter:  , S_UR_977 , 263 , 0.96354 , 5 ,  4 , 1
SelfishReporter:  , S_UR_979 , 264 , 0.999815 , 11 ,  9 , 2
SelfishReporter:  , S_UR_980 , 265 , 0.999818 , 9 ,  8 , 1
SelfishReporter:  , S_UR_982 , 266 , 0.609819 , 1 ,  1 , 0
SelfishReporter:  , S_UR_983 , 267 , 0.99739 , 13 ,  9 , 4
SelfishReporter:  , S_UR_984 , 268 , 0.609819 , 1 ,  1 , 0
SelfishReporter:  , S_UR_985 , 269 , -0.609948 , 1 ,  0 , 1
SelfishReporter:  , S_UR_986 , 270 , 0.999318 , 28 ,  17 , 11
SelfishReporter:  , S_UR_989 , 271 , 0.963784 , 3 ,  3 , 0
HonestReporter:  , H_LL_90 , 272 , 1 ,  26 , 26 , 0
HonestReporter:  , H_LL_91 , 273 , 1 ,  58 , 58 , 0
HonestReporter:  , H_LL_92 , 274 , 1 ,  49 , 49 , 0
HonestReporter:  , H_LL_93 , 275 , 1 ,  40 , 40 , 0
HonestReporter:  , H_LL_94 , 276 , 1 ,  56 , 56 , 0
HonestReporter:  , H_LL_95 , 277 , 1 ,  52 , 52 , 0
HonestReporter:  , H_LL_96 , 278 , 1 ,  53 , 53 , 0
HonestReporter:  , H_LL_97 , 279 , 1 ,  56 , 56 , 0
HonestReporter:  , H_LL_98 , 280 , 1 ,  60 , 60 , 0
HonestReporter:  , H_LL_99 , 281 , 1 ,  57 , 57 , 0
HonestReporter:  , H_LL_100 , 282 , 1 ,  37 , 37 , 0
HonestReporter:  , H_LL_101 , 283 , 1 ,  14 , 14 , 0
HonestReporter:  , H_LL_102 , 284 , 1 ,  38 , 38 , 0
HonestReporter:  , H_LL_103 , 285 , 1 ,  41 , 41 , 0
HonestReporter:  , H_LL_104 , 286 , 1 ,  53 , 53 , 0
HonestReporter:  , H_LL_105 , 287 , 1 ,  58 , 58 , 0
HonestReporter:  , H_LL_106 , 288 , 1 ,  51 , 51 , 0
HonestReporter:  , H_LL_107 , 289 , 1 ,  40 , 40 , 0
HonestReporter:  , H_LL_108 , 290 , 1 ,  16 , 16 , 0
HonestReporter:  , H_LL_109 , 291 , 1 ,  65 , 65 , 0
HonestReporter:  , H_LL_110 , 292 , 1 ,  53 , 53 , 0
HonestReporter:  , H_LL_111 , 293 , 1 ,  45 , 45 , 0
HonestReporter:  , H_LL_112 , 294 , 1 ,  65 , 65 , 0
HonestReporter:  , H_LL_113 , 295 , 1 ,  44 , 44 , 0
HonestReporter:  , H_LL_114 , 296 , 1 ,  37 , 37 , 0
HonestReporter:  , H_LL_115 , 297 , 1 ,  47 , 47 , 0
HonestReporter:  , H_LL_116 , 298 , 1 ,  38 , 38 , 0
HonestReporter:  , H_LL_117 , 299 , 1 ,  53 , 53 , 0
HonestReporter:  , H_LL_118 , 300 , 1 ,  56 , 56 , 0
HonestReporter:  , H_LL_119 , 301 , 1 ,  35 , 35 , 0
HonestReporter:  , H_LL_120 , 302 , 1 ,  52 , 52 , 0
HonestReporter:  , H_LL_121 , 303 , 1 ,  41 , 41 , 0
HonestReporter:  , H_LL_122 , 304 , 1 ,  23 , 23 , 0
HonestReporter:  , H_LL_123 , 305 , 1 ,  37 , 37 , 0
HonestReporter:  , H_LL_124 , 306 , 1 ,  66 , 66 , 0
HonestReporter:  , H_LL_125 , 307 , 1 ,  69 , 69 , 0
HonestReporter:  , H_LL_126 , 308 , 0.999309 ,  6 , 6 , 0
HonestReporter:  , H_LL_127 , 309 , 1 ,  51 , 51 , 0
HonestReporter:  , H_LL_128 , 310 , 1 ,  45 , 45 , 0
HonestReporter:  , H_LL_129 , 311 , 1 ,  56 , 56 , 0
HonestReporter:  , H_LL_130 , 312 , 1 ,  41 , 41 , 0
HonestReporter:  , H_LL_131 , 313 , 1 ,  17 , 17 , 0
HonestReporter:  , H_LL_132 , 314 , 1 ,  60 , 60 , 0
HonestReporter:  , H_LL_133 , 315 , 1 ,  65 , 65 , 0
HonestReporter:  , H_LL_134 , 316 , 1 ,  67 , 67 , 0
HonestReporter:  , H_LL_135 , 317 , 1 ,  51 , 51 , 0
HonestReporter:  , H_LL_136 , 318 , 1 ,  32 , 32 , 0
HonestReporter:  , H_LL_137 , 319 , 1 ,  52 , 52 , 0
HonestReporter:  , H_LL_138 , 320 , 1 ,  47 , 47 , 0
HonestReporter:  , H_LL_139 , 321 , 1 ,  58 , 58 , 0
HonestReporter:  , H_LL_140 , 322 , 1 ,  29 , 29 , 0
HonestReporter:  , H_LL_141 , 323 , 1 ,  34 , 34 , 0
HonestReporter:  , H_LL_142 , 324 , 1 ,  15 , 15 , 0
HonestReporter:  , H_LL_143 , 325 , 1 ,  54 , 54 , 0
HonestReporter:  , H_LL_144 , 326 , 1 ,  40 , 40 , 0
HonestReporter:  , H_LL_145 , 327 , 1 ,  54 , 54 , 0
HonestReporter:  , H_LL_146 , 328 , 1 ,  53 , 53 , 0
HonestReporter:  , H_LL_147 , 329 , 1 ,  56 , 56 , 0
HonestReporter:  , H_LL_148 , 330 , 1 ,  46 , 46 , 0
HonestReporter:  , H_LL_149 , 331 , 1 ,  22 , 22 , 0
HonestReporter:  , H_LL_150 , 332 , 1 ,  49 , 49 , 0
HonestReporter:  , H_LL_151 , 333 , 1 ,  45 , 45 , 0
HonestReporter:  , H_LL_152 , 334 , 1 ,  36 , 36 , 0
HonestReporter:  , H_LL_153 , 335 , 1 ,  53 , 53 , 0
HonestReporter:  , H_LL_154 , 336 , 1 ,  16 , 16 , 0
HonestReporter:  , H_LL_155 , 337 , 1 ,  60 , 60 , 0
HonestReporter:  , H_LL_156 , 338 , 1 ,  61 , 61 , 0
HonestReporter:  , H_LL_157 , 339 , 1 ,  45 , 45 , 0
HonestReporter:  , H_LL_158 , 340 , 1 ,  45 , 45 , 0
HonestReporter:  , H_LL_159 , 341 , 1 ,  51 , 51 , 0
HonestReporter:  , H_LL_160 , 342 , 1 ,  62 , 62 , 0
HonestReporter:  , H_LL_161 , 343 , 1 ,  34 , 34 , 0
HonestReporter:  , H_LL_162 , 344 , 1 ,  29 , 29 , 0
HonestReporter:  , H_LL_163 , 345 , 1 ,  25 , 25 , 0
HonestReporter:  , H_LL_164 , 346 , 1 ,  30 , 30 , 0
HonestReporter:  , H_LL_165 , 347 , 1 ,  59 , 59 , 0
HonestReporter:  , H_LL_166 , 348 , 1 ,  29 , 29 , 0
HonestReporter:  , H_LL_167 , 349 , 1 ,  44 , 44 , 0
HonestReporter:  , H_LL_168 , 350 , 1 ,  52 , 52 , 0
HonestReporter:  , H_LL_169 , 351 , 1 ,  51 , 51 , 0
HonestReporter:  , H_LL_170 , 352 , 1 ,  48 , 48 , 0
HonestReporter:  , H_LL_171 , 353 , 1 ,  50 , 50 , 0
HonestReporter:  , H_LL_172 , 354 , 1 ,  40 , 40 , 0
HonestReporter:  , H_LL_173 , 355 , 1 ,  30 , 30 , 0
HonestReporter:  , H_LL_174 , 356 , 1 ,  52 , 52 , 0
HonestReporter:  , H_LL_175 , 357 , 1 ,  44 , 44 , 0
HonestReporter:  , H_LL_176 , 358 , 1 ,  55 , 55 , 0
HonestReporter:  , H_LL_177 , 359 , 1 ,  53 , 53 , 0
HonestReporter:  , H_LL_178 , 360 , 1 ,  60 , 60 , 0
HonestReporter:  , H_LL_179 , 361 , 1 ,  58 , 58 , 0
HonestReporter:  , H_LL_180 , 362 , 1 ,  36 , 36 , 0
HonestReporter:  , H_LL_181 , 363 , 1 ,  46 , 46 , 0
HonestReporter:  , H_LL_182 , 364 , 1 ,  37 , 37 , 0
HonestReporter:  , H_LL_183 , 365 , 1 ,  54 , 54 , 0
HonestReporter:  , H_LL_184 , 366 , 1 ,  19 , 19 , 0
HonestReporter:  , H_LL_185 , 367 , 1 ,  26 , 26 , 0
HonestReporter:  , H_LL_186 , 368 , 1 ,  41 , 41 , 0
HonestReporter:  , H_LL_187 , 369 , 1 ,  50 , 50 , 0
HonestReporter:  , H_LL_188 , 370 , 1 ,  40 , 40 , 0
HonestReporter:  , H_LL_189 , 371 , 1 ,  55 , 55 , 0
HonestReporter:  , H_LL_190 , 372 , 1 ,  40 , 40 , 0
HonestReporter:  , H_LL_191 , 373 , 1 ,  17 , 17 , 0
HonestReporter:  , H_LL_192 , 374 , 1 ,  59 , 59 , 0
HonestReporter:  , H_LL_193 , 375 , 1 ,  36 , 36 , 0
HonestReporter:  , H_LL_194 , 376 , 1 ,  59 , 59 , 0
HonestReporter:  , H_LL_195 , 377 , 1 ,  43 , 43 , 0
HonestReporter:  , H_LL_196 , 378 , 1 ,  24 , 24 , 0
HonestReporter:  , H_LL_197 , 379 , 1 ,  58 , 58 , 0
HonestReporter:  , H_LL_198 , 380 , 1 ,  62 , 62 , 0
HonestReporter:  , H_LL_199 , 381 , 1 ,  39 , 39 , 0
HonestReporter:  , H_LL_200 , 382 , 1 ,  60 , 60 , 0
HonestReporter:  , H_LL_201 , 383 , 1 ,  60 , 60 , 0
HonestReporter:  , H_LL_202 , 384 , 1 ,  27 , 27 , 0
HonestReporter:  , H_LL_203 , 385 , 1 ,  58 , 58 , 0
HonestReporter:  , H_LL_204 , 386 , 1 ,  62 , 62 , 0
HonestReporter:  , H_LL_205 , 387 , 1 ,  53 , 53 , 0
HonestReporter:  , H_LL_206 , 388 , 1 ,  58 , 58 , 0
HonestReporter:  , H_LL_207 , 389 , 1 ,  27 , 27 , 0
HonestReporter:  , H_LL_208 , 390 , 1 ,  62 , 62 , 0
HonestReporter:  , H_LL_209 , 391 , 1 ,  39 , 39 , 0
HonestReporter:  , H_LL_210 , 392 , 1 ,  56 , 56 , 0
HonestReporter:  , H_LL_211 , 393 , 1 ,  41 , 41 , 0
HonestReporter:  , H_LL_212 , 394 , 1 ,  65 , 65 , 0
HonestReporter:  , H_LL_213 , 395 , 1 ,  39 , 39 , 0
HonestReporter:  , H_LL_214 , 396 , 1 ,  52 , 52 , 0
HonestReporter:  , H_LL_215 , 397 , 1 ,  42 , 42 , 0
HonestReporter:  , H_LL_216 , 398 , 1 ,  18 , 18 , 0
HonestReporter:  , H_LL_217 , 399 , 1 ,  39 , 39 , 0
HonestReporter:  , H_LL_218 , 400 , 1 ,  59 , 59 , 0
HonestReporter:  , H_LL_219 , 401 , 1 ,  41 , 41 , 0
HonestReporter:  , H_LL_220 , 402 , 1 ,  32 , 32 , 0
HonestReporter:  , H_LL_221 , 403 , 1 ,  18 , 18 , 0
HonestReporter:  , H_LL_222 , 404 , 1 ,  36 , 36 , 0
HonestReporter:  , H_LL_223 , 405 , 1 ,  29 , 29 , 0
HonestReporter:  , H_LL_224 , 406 , 1 ,  44 , 44 , 0
HonestReporter:  , H_LL_225 , 407 , 1 ,  39 , 39 , 0
HonestReporter:  , H_LL_226 , 408 , 0.999987 ,  9 , 9 , 0
HonestReporter:  , H_LL_227 , 409 , 1 ,  60 , 60 , 0
HonestReporter:  , H_LL_228 , 410 , 1 ,  62 , 62 , 0
HonestReporter:  , H_LL_229 , 411 , 1 ,  31 , 31 , 0
HonestReporter:  , H_LL_230 , 412 , 1 ,  39 , 39 , 0
HonestReporter:  , H_LL_231 , 413 , 1 ,  49 , 49 , 0
HonestReporter:  , H_LL_232 , 414 , 1 ,  29 , 29 , 0
HonestReporter:  , H_LL_233 , 415 , 1 ,  60 , 60 , 0
HonestReporter:  , H_LL_234 , 416 , 1 ,  57 , 57 , 0
HonestReporter:  , H_LL_235 , 417 , 1 ,  56 , 56 , 0
HonestReporter:  , H_LL_236 , 418 , 1 ,  62 , 62 , 0
HonestReporter:  , H_LL_237 , 419 , 1 ,  37 , 37 , 0
HonestReporter:  , H_LL_238 , 420 , 1 ,  48 , 48 , 0
HonestReporter:  , H_LL_239 , 421 , 1 ,  69 , 69 , 0
HonestReporter:  , H_LL_240 , 422 , 1 ,  55 , 55 , 0
HonestReporter:  , H_LL_241 , 423 , 1 ,  55 , 55 , 0
HonestReporter:  , H_LL_242 , 424 , 1 ,  48 , 48 , 0
HonestReporter:  , H_LL_243 , 425 , 1 ,  58 , 58 , 0
HonestReporter:  , H_LL_244 , 426 , 1 ,  35 , 35 , 0
HonestReporter:  , H_LL_245 , 427 , 1 ,  40 , 40 , 0
HonestReporter:  , H_LL_246 , 428 , 1 ,  62 , 62 , 0
HonestReporter:  , H_LL_247 , 429 , 1 ,  53 , 53 , 0
HonestReporter:  , H_LL_248 , 430 , 1 ,  51 , 51 , 0
HonestReporter:  , H_LL_249 , 431 , 1 ,  12 , 12 , 0
HonestReporter:  , H_LL_250 , 432 , 1 ,  49 , 49 , 0
HonestReporter:  , H_LL_251 , 433 , 1 ,  45 , 45 , 0
HonestReporter:  , H_LL_252 , 434 , 1 ,  45 , 45 , 0
HonestReporter:  , H_LL_253 , 435 , 1 ,  59 , 59 , 0
HonestReporter:  , H_LL_254 , 436 , 1 ,  52 , 52 , 0
HonestReporter:  , H_LL_255 , 437 , 1 ,  52 , 52 , 0
HonestReporter:  , H_LL_256 , 438 , 1 ,  48 , 48 , 0
HonestReporter:  , H_LL_257 , 439 , 1 ,  29 , 29 , 0
HonestReporter:  , H_LL_258 , 440 , 1 ,  21 , 21 , 0
HonestReporter:  , H_LL_259 , 441 , 1 ,  49 , 49 , 0
HonestReporter:  , H_LL_260 , 442 , 1 ,  28 , 28 , 0
HonestReporter:  , H_LL_261 , 443 , 1 ,  61 , 61 , 0
HonestReporter:  , H_LL_262 , 444 , 1 ,  52 , 52 , 0
HonestReporter:  , H_LL_263 , 445 , 1 ,  48 , 48 , 0
HonestReporter:  , H_LL_264 , 446 , 1 ,  47 , 47 , 0
HonestReporter:  , H_LL_265 , 447 , 1 ,  51 , 51 , 0
HonestReporter:  , H_LL_266 , 448 , 1 ,  37 , 37 , 0
HonestReporter:  , H_LL_267 , 449 , 1 ,  37 , 37 , 0
HonestReporter:  , H_LL_268 , 450 , 1 ,  50 , 50 , 0
HonestReporter:  , H_LL_269 , 451 , 1 ,  29 , 29 , 0
HonestReporter:  , H_LL_270 , 452 , 1 ,  45 , 45 , 0
HonestReporter:  , H_LL_271 , 453 , 1 ,  47 , 47 , 0
HonestReporter:  , H_LL_272 , 454 , 1 ,  45 , 45 , 0
HonestReporter:  , H_LL_273 , 455 , 1 ,  60 , 60 , 0
HonestReporter:  , H_LL_274 , 456 , 1 ,  38 , 38 , 0
HonestReporter:  , H_LL_275 , 457 , 1 ,  52 , 52 , 0
HonestReporter:  , H_LL_276 , 458 , 1 ,  51 , 51 , 0
HonestReporter:  , H_LL_277 , 459 , 1 ,  51 , 51 , 0
HonestReporter:  , H_LL_278 , 460 , 1 ,  44 , 44 , 0
HonestReporter:  , H_LL_279 , 461 , 1 ,  54 , 54 , 0
HonestReporter:  , H_LL_280 , 462 , 1 ,  34 , 34 , 0
HonestReporter:  , H_LL_281 , 463 , 1 ,  43 , 43 , 0
HonestReporter:  , H_LL_282 , 464 , 1 ,  63 , 63 , 0
HonestReporter:  , H_LL_283 , 465 , 1 ,  59 , 59 , 0
HonestReporter:  , H_LL_284 , 466 , 1 ,  60 , 60 , 0
HonestReporter:  , H_LL_285 , 467 , 1 ,  54 , 54 , 0
HonestReporter:  , H_LL_286 , 468 , 1 ,  61 , 61 , 0
HonestReporter:  , H_LL_287 , 469 , 1 ,  52 , 52 , 0
HonestReporter:  , H_LL_288 , 470 , 1 ,  55 , 55 , 0
HonestReporter:  , H_LL_289 , 471 , 1 ,  53 , 53 , 0
HonestReporter:  , H_LL_290 , 472 , 1 ,  33 , 33 , 0
HonestReporter:  , H_LL_291 , 473 , 1 ,  48 , 48 , 0
HonestReporter:  , H_LL_292 , 474 , 1 ,  53 , 53 , 0
HonestReporter:  , H_LL_293 , 475 , 1 ,  45 , 45 , 0
HonestReporter:  , H_LL_294 , 476 , 1 ,  59 , 59 , 0
HonestReporter:  , H_LL_295 , 477 , 1 ,  50 , 50 , 0
HonestReporter:  , H_LL_296 , 478 , 1 ,  45 , 45 , 0
HonestReporter:  , H_LL_297 , 479 , 1 ,  24 , 24 , 0
HonestReporter:  , H_LL_298 , 480 , 1 ,  35 , 35 , 0
HonestReporter:  , H_LL_299 , 481 , 1 ,  26 , 26 , 0
HonestReporter:  , H_LR_390 , 482 , 0.871618 ,  2 , 2 , 0
HonestReporter:  , H_LR_391 , 483 , 0.963564 ,  3 , 3 , 0
HonestReporter:  , H_LR_392 , 484 , 0.871618 ,  2 , 2 , 0
HonestReporter:  , H_LR_394 , 485 , 0.871676 ,  2 , 2 , 0
HonestReporter:  , H_LR_395 , 486 , 0.999987 ,  9 , 9 , 0
HonestReporter:  , H_LR_397 , 487 , 0.990188 ,  4 , 4 , 0
HonestReporter:  , H_LR_398 , 488 , 0.610959 ,  1 , 1 , 0
HonestReporter:  , H_LR_399 , 489 , 0.963933 ,  3 , 3 , 0
HonestReporter:  , H_LR_400 , 490 , 0.999999 ,  11 , 11 , 0
HonestReporter:  , H_LR_402 , 491 , 1 ,  48 , 48 , 0
HonestReporter:  , H_LR_403 , 492 , 0.963978 ,  3 , 3 , 0
HonestReporter:  , H_LR_404 , 493 , 0.610959 ,  1 , 1 , 0
HonestReporter:  , H_LR_406 , 494 , 0.990189 ,  4 , 4 , 0
HonestReporter:  , H_LR_407 , 495 , 0.997404 ,  5 , 5 , 0
HonestReporter:  , H_LR_408 , 496 , 0.872503 ,  2 , 2 , 0
HonestReporter:  , H_LR_409 , 497 , 0.999951 ,  8 , 8 , 0
HonestReporter:  , H_LR_410 , 498 , 0.999987 ,  9 , 9 , 0
HonestReporter:  , H_LR_411 , 499 , 1 ,  22 , 22 , 0
HonestReporter:  , H_LR_412 , 500 , 0.997418 ,  5 , 5 , 0
HonestReporter:  , H_LR_413 , 501 , 0.999952 ,  8 , 8 , 0
HonestReporter:  , H_LR_415 , 502 , 1 ,  28 , 28 , 0
HonestReporter:  , H_LR_416 , 503 , 1 ,  26 , 26 , 0
HonestReporter:  , H_LR_417 , 504 , 0.999952 ,  8 , 8 , 0
HonestReporter:  , H_LR_418 , 505 , 0.990316 ,  4 , 4 , 0
HonestReporter:  , H_LR_419 , 506 , 1 ,  22 , 22 , 0
HonestReporter:  , H_LR_420 , 507 , 1 ,  27 , 27 , 0
HonestReporter:  , H_LR_421 , 508 , 1 ,  16 , 16 , 0
HonestReporter:  , H_LR_422 , 509 , 0.610959 ,  1 , 1 , 0
HonestReporter:  , H_LR_423 , 510 , 1 ,  35 , 35 , 0
HonestReporter:  , H_LR_424 , 511 , 1 ,  19 , 19 , 0
HonestReporter:  , H_LR_425 , 512 , 1 ,  17 , 17 , 0
HonestReporter:  , H_LR_426 , 513 , 0.997403 ,  5 , 5 , 0
HonestReporter:  , H_LR_430 , 514 , 0.963933 ,  3 , 3 , 0
HonestReporter:  , H_LR_431 , 515 , 0.999952 ,  8 , 8 , 0
HonestReporter:  , H_LR_432 , 516 , 0.990256 ,  4 , 4 , 0
HonestReporter:  , H_LR_433 , 517 , 0.963713 ,  3 , 3 , 0
HonestReporter:  , H_LR_434 , 518 , 0.872503 ,  2 , 2 , 0
HonestReporter:  , H_LR_435 , 519 , 0.610959 ,  1 , 1 , 0
HonestReporter:  , H_LR_437 , 520 , 0.999815 ,  7 , 7 , 0
HonestReporter:  , H_LR_438 , 521 , 0.999299 ,  6 , 6 , 0
HonestReporter:  , H_LR_439 , 522 , 0.61126 ,  1 , 1 , 0
HonestReporter:  , H_LR_441 , 523 , 0.999818 ,  7 , 7 , 0
HonestReporter:  , H_LR_443 , 524 , 0.610959 ,  1 , 1 , 0
HonestReporter:  , H_LR_444 , 525 , 0.963764 ,  3 , 3 , 0
HonestReporter:  , H_LR_445 , 526 , 0.872503 ,  2 , 2 , 0
HonestReporter:  , H_LR_447 , 527 , 1 ,  12 , 12 , 0
HonestReporter:  , H_LR_449 , 528 , 1 ,  15 , 15 , 0
HonestReporter:  , H_LR_450 , 529 , 0.872503 ,  2 , 2 , 0
HonestReporter:  , H_LR_451 , 530 , 0.871173 ,  2 , 2 , 0
HonestReporter:  , H_LR_452 , 531 , 0.999311 ,  6 , 6 , 0
HonestReporter:  , H_LR_453 , 532 , 0.871835 ,  2 , 2 , 0
HonestReporter:  , H_LR_454 , 533 , 0.610959 ,  1 , 1 , 0
HonestReporter:  , H_LR_455 , 534 , 0.872503 ,  2 , 2 , 0
HonestReporter:  , H_LR_456 , 535 , 0.963933 ,  3 , 3 , 0
HonestReporter:  , H_LR_457 , 536 , 1 ,  21 , 21 , 0
HonestReporter:  , H_LR_458 , 537 , 1 ,  25 , 25 , 0
HonestReporter:  , H_LR_459 , 538 , 1 ,  26 , 26 , 0
HonestReporter:  , H_LR_462 , 539 , 0.610966 ,  1 , 1 , 0
HonestReporter:  , H_LR_464 , 540 , 0.963764 ,  3 , 3 , 0
HonestReporter:  , H_LR_465 , 541 , 0.963933 ,  3 , 3 , 0
HonestReporter:  , H_LR_466 , 542 , 0.963713 ,  3 , 3 , 0
HonestReporter:  , H_LR_467 , 543 , 1 ,  19 , 19 , 0
HonestReporter:  , H_LR_468 , 544 , 0.999951 ,  8 , 8 , 0
HonestReporter:  , H_LR_469 , 545 , 0.963933 ,  3 , 3 , 0
HonestReporter:  , H_LR_470 , 546 , 0.872503 ,  2 , 2 , 0
HonestReporter:  , H_LR_471 , 547 , 0.999952 ,  8 , 8 , 0
HonestReporter:  , H_LR_473 , 548 , 0.872503 ,  2 , 2 , 0
HonestReporter:  , H_LR_475 , 549 , 0.871618 ,  2 , 2 , 0
HonestReporter:  , H_LR_476 , 550 , 0.872503 ,  2 , 2 , 0
HonestReporter:  , H_LR_477 , 551 , 0.99025 ,  4 , 4 , 0
HonestReporter:  , H_LR_478 , 552 , 0.999307 ,  6 , 6 , 0
HonestReporter:  , H_LR_480 , 553 , 0.872503 ,  2 , 2 , 0
HonestReporter:  , H_LR_481 , 554 , 0.610959 ,  1 , 1 , 0
HonestReporter:  , H_LR_482 , 555 , 0.990189 ,  4 , 4 , 0
HonestReporter:  , H_LR_483 , 556 , 0.610959 ,  1 , 1 , 0
HonestReporter:  , H_LR_484 , 557 , 1 ,  19 , 19 , 0
HonestReporter:  , H_LR_485 , 558 , 0.963978 ,  3 , 3 , 0
HonestReporter:  , H_LR_486 , 559 , 0.872503 ,  2 , 2 , 0
HonestReporter:  , H_LR_487 , 560 , 1 ,  28 , 28 , 0
HonestReporter:  , H_LR_488 , 561 , 1 ,  17 , 17 , 0
HonestReporter:  , H_LR_489 , 562 , 0.872503 ,  2 , 2 , 0
HonestReporter:  , H_LR_490 , 563 , 1 ,  15 , 15 , 0
HonestReporter:  , H_LR_491 , 564 , 0.999987 ,  9 , 9 , 0
HonestReporter:  , H_LR_492 , 565 , 0.610959 ,  1 , 1 , 0
HonestReporter:  , H_LR_497 , 566 , 1 ,  26 , 26 , 0
HonestReporter:  , H_LR_498 , 567 , 1 ,  29 , 29 , 0
HonestReporter:  , H_LR_499 , 568 , 0.872409 ,  2 , 2 , 0
HonestReporter:  , H_LR_500 , 569 , 0.999814 ,  7 , 7 , 0
HonestReporter:  , H_LR_501 , 570 , 1 ,  17 , 17 , 0
HonestReporter:  , H_LR_502 , 571 , 1 ,  40 , 40 , 0
HonestReporter:  , H_LR_503 , 572 , 0.999309 ,  6 , 6 , 0
HonestReporter:  , H_LR_505 , 573 , 0.999997 ,  10 , 10 , 0
HonestReporter:  , H_LR_506 , 574 , 0.963933 ,  3 , 3 , 0
HonestReporter:  , H_LR_507 , 575 , 1 ,  29 , 29 , 0
HonestReporter:  , H_LR_508 , 576 , 0.610966 ,  1 , 1 , 0
HonestReporter:  , H_LR_509 , 577 , 0.610959 ,  1 , 1 , 0
HonestReporter:  , H_LR_510 , 578 , 1 ,  16 , 16 , 0
HonestReporter:  , H_LR_511 , 579 , 1 ,  35 , 35 , 0
HonestReporter:  , H_LR_512 , 580 , 1 ,  44 , 44 , 0
HonestReporter:  , H_LR_513 , 581 , 0.963713 ,  3 , 3 , 0
HonestReporter:  , H_LR_515 , 582 , 0.999999 ,  11 , 11 , 0
HonestReporter:  , H_LR_518 , 583 , 1 ,  23 , 23 , 0
HonestReporter:  , H_LR_519 , 584 , 0.963764 ,  3 , 3 , 0
HonestReporter:  , H_LR_520 , 585 , 1 ,  49 , 49 , 0
HonestReporter:  , H_LR_521 , 586 , 0.999999 ,  11 , 11 , 0
HonestReporter:  , H_LR_523 , 587 , 1 ,  20 , 20 , 0
HonestReporter:  , H_LR_524 , 588 , 0.872503 ,  2 , 2 , 0
HonestReporter:  , H_LR_525 , 589 , 0.99025 ,  4 , 4 , 0
HonestReporter:  , H_LR_526 , 590 , 0.990217 ,  4 , 4 , 0
HonestReporter:  , H_LR_527 , 591 , 0.999997 ,  10 , 10 , 0
HonestReporter:  , H_LR_528 , 592 , 0.610959 ,  1 , 1 , 0
HonestReporter:  , H_LR_529 , 593 , 0.610959 ,  1 , 1 , 0
HonestReporter:  , H_LR_530 , 594 , 0.963933 ,  3 , 3 , 0
HonestReporter:  , H_LR_533 , 595 , 0.999312 ,  6 , 6 , 0
HonestReporter:  , H_LR_534 , 596 , 0.610959 ,  1 , 1 , 0
HonestReporter:  , H_LR_535 , 597 , 0.997422 ,  5 , 5 , 0
HonestReporter:  , H_LR_536 , 598 , 0.963933 ,  3 , 3 , 0
HonestReporter:  , H_LR_539 , 599 , 1 ,  15 , 15 , 0
HonestReporter:  , H_LR_540 , 600 , 1 ,  13 , 13 , 0
HonestReporter:  , H_LR_541 , 601 , 0.872503 ,  2 , 2 , 0
HonestReporter:  , H_LR_542 , 602 , 1 ,  14 , 14 , 0
HonestReporter:  , H_LR_543 , 603 , 0.999951 ,  8 , 8 , 0
HonestReporter:  , H_LR_544 , 604 , 1 ,  12 , 12 , 0
HonestReporter:  , H_LR_546 , 605 , 1 ,  19 , 19 , 0
HonestReporter:  , H_LR_547 , 606 , 0.872503 ,  2 , 2 , 0
HonestReporter:  , H_LR_548 , 607 , 0.997382 ,  5 , 5 , 0
HonestReporter:  , H_LR_549 , 608 , 0.963564 ,  3 , 3 , 0
HonestReporter:  , H_LR_551 , 609 , 0.872503 ,  2 , 2 , 0
HonestReporter:  , H_LR_552 , 610 , 0.610959 ,  1 , 1 , 0
HonestReporter:  , H_LR_553 , 611 , 0.872409 ,  2 , 2 , 0
HonestReporter:  , H_LR_555 , 612 , 0.999996 ,  10 , 10 , 0
HonestReporter:  , H_LR_556 , 613 , 0.999814 ,  7 , 7 , 0
HonestReporter:  , H_LR_557 , 614 , 0.999307 ,  6 , 6 , 0
HonestReporter:  , H_LR_558 , 615 , 0.999951 ,  8 , 8 , 0
HonestReporter:  , H_LR_559 , 616 , 1 ,  15 , 15 , 0
HonestReporter:  , H_LR_560 , 617 , 0.963713 ,  3 , 3 , 0
HonestReporter:  , H_LR_561 , 618 , 1 ,  27 , 27 , 0
HonestReporter:  , H_LR_562 , 619 , 0.872503 ,  2 , 2 , 0
HonestReporter:  , H_LR_563 , 620 , 1 ,  21 , 21 , 0
HonestReporter:  , H_LR_564 , 621 , 0.999987 ,  9 , 9 , 0
HonestReporter:  , H_LR_565 , 622 , 0.610959 ,  1 , 1 , 0
HonestReporter:  , H_LR_567 , 623 , 0.872503 ,  2 , 2 , 0
HonestReporter:  , H_LR_569 , 624 , 0.997414 ,  5 , 5 , 0
HonestReporter:  , H_LR_570 , 625 , 0.963933 ,  3 , 3 , 0
HonestReporter:  , H_LR_572 , 626 , 0.99025 ,  4 , 4 , 0
HonestReporter:  , H_LR_573 , 627 , 1 ,  13 , 13 , 0
HonestReporter:  , H_LR_574 , 628 , 0.872503 ,  2 , 2 , 0
HonestReporter:  , H_LR_575 , 629 , 0.610966 ,  1 , 1 , 0
HonestReporter:  , H_LR_576 , 630 , 1 ,  12 , 12 , 0
HonestReporter:  , H_LR_577 , 631 , 1 ,  16 , 16 , 0
HonestReporter:  , H_LR_578 , 632 , 0.872503 ,  2 , 2 , 0
HonestReporter:  , H_LR_579 , 633 , 1 ,  12 , 12 , 0
HonestReporter:  , H_LR_580 , 634 , 0.872503 ,  2 , 2 , 0
HonestReporter:  , H_LR_581 , 635 , 1 ,  37 , 37 , 0
HonestReporter:  , H_LR_583 , 636 , 0.990204 ,  4 , 4 , 0
HonestReporter:  , H_LR_584 , 637 , 1 ,  28 , 28 , 0
HonestReporter:  , H_LR_586 , 638 , 0.610966 ,  1 , 1 , 0
HonestReporter:  , H_LR_587 , 639 , 1 ,  22 , 22 , 0
HonestReporter:  , H_LR_588 , 640 , 1 ,  23 , 23 , 0
HonestReporter:  , H_LR_589 , 641 , 1 ,  26 , 26 , 0
HonestReporter:  , H_LR_590 , 642 , 1 ,  13 , 13 , 0
HonestReporter:  , H_LR_591 , 643 , 1 ,  29 , 29 , 0
HonestReporter:  , H_LR_593 , 644 , 0.963808 ,  3 , 3 , 0
HonestReporter:  , H_LR_594 , 645 , 0.997364 ,  5 , 5 , 0
HonestReporter:  , H_LR_595 , 646 , 0.999999 ,  11 , 11 , 0
HonestReporter:  , H_LR_597 , 647 , 0.61126 ,  1 , 1 , 0
HonestReporter:  , H_LR_599 , 648 , 0.872503 ,  2 , 2 , 0
HonestReporter:  , H_UL_690 , 649 , 1 ,  35 , 35 , 0
HonestReporter:  , H_UL_695 , 650 , 0.999987 ,  9 , 9 , 0
HonestReporter:  , H_UL_696 , 651 , 0.612903 ,  1 , 1 , 0
HonestReporter:  , H_UL_698 , 652 , 0.990224 ,  4 , 4 , 0
HonestReporter:  , H_UL_699 , 653 , 0.999821 ,  7 , 7 , 0
HonestReporter:  , H_UL_700 , 654 , 1 ,  12 , 12 , 0
HonestReporter:  , H_UL_701 , 655 , 0.964039 ,  3 , 3 , 0
HonestReporter:  , H_UL_702 , 656 , 1 ,  12 , 12 , 0
HonestReporter:  , H_UL_703 , 657 , 1 ,  37 , 37 , 0
HonestReporter:  , H_UL_705 , 658 , 1 ,  16 , 16 , 0
HonestReporter:  , H_UL_706 , 659 , 0.610667 ,  1 , 1 , 0
HonestReporter:  , H_UL_707 , 660 , 0.997427 ,  5 , 5 , 0
HonestReporter:  , H_UL_709 , 661 , 1 ,  26 , 26 , 0
HonestReporter:  , H_UL_710 , 662 , 0.609694 ,  1 , 1 , 0
HonestReporter:  , H_UL_711 , 663 , 1 ,  30 , 30 , 0
HonestReporter:  , H_UL_712 , 664 , 0.871806 ,  2 , 2 , 0
HonestReporter:  , H_UL_713 , 665 , 1 ,  22 , 22 , 0
HonestReporter:  , H_UL_714 , 666 , 1 ,  32 , 32 , 0
HonestReporter:  , H_UL_715 , 667 , 0.999817 ,  7 , 7 , 0
HonestReporter:  , H_UL_716 , 668 , 1 ,  22 , 22 , 0
HonestReporter:  , H_UL_717 , 669 , 0.611111 ,  1 , 1 , 0
HonestReporter:  , H_UL_718 , 670 , 0.999323 ,  6 , 6 , 0
HonestReporter:  , H_UL_721 , 671 , 1 ,  13 , 13 , 0
HonestReporter:  , H_UL_722 , 672 , 0.990331 ,  4 , 4 , 0
HonestReporter:  , H_UL_723 , 673 , 1 ,  51 , 51 , 0
HonestReporter:  , H_UL_724 , 674 , 1 ,  43 , 43 , 0
HonestReporter:  , H_UL_725 , 675 , 1 ,  29 , 29 , 0
HonestReporter:  , H_UL_726 , 676 , 0.990331 ,  4 , 4 , 0
HonestReporter:  , H_UL_727 , 677 , 0.990309 ,  4 , 4 , 0
HonestReporter:  , H_UL_728 , 678 , 0.873189 ,  2 , 2 , 0
HonestReporter:  , H_UL_729 , 679 , 0.990326 ,  4 , 4 , 0
HonestReporter:  , H_UL_732 , 680 , 0.999987 ,  9 , 9 , 0
HonestReporter:  , H_UL_734 , 681 , 0.873189 ,  2 , 2 , 0
HonestReporter:  , H_UL_736 , 682 , 0.997427 ,  5 , 5 , 0
HonestReporter:  , H_UL_738 , 683 , 0.997443 ,  5 , 5 , 0
HonestReporter:  , H_UL_739 , 684 , 1 ,  36 , 36 , 0
HonestReporter:  , H_UL_740 , 685 , 0.612903 ,  1 , 1 , 0
HonestReporter:  , H_UL_741 , 686 , 1 ,  22 , 22 , 0
HonestReporter:  , H_UL_742 , 687 , 1 ,  34 , 34 , 0
HonestReporter:  , H_UL_743 , 688 , 1 ,  37 , 37 , 0
HonestReporter:  , H_UL_744 , 689 , 0.999951 ,  8 , 8 , 0
HonestReporter:  , H_UL_745 , 690 , 0.611111 ,  1 , 1 , 0
HonestReporter:  , H_UL_747 , 691 , 1 ,  34 , 34 , 0
HonestReporter:  , H_UL_749 , 692 , 0.997441 ,  5 , 5 , 0
HonestReporter:  , H_UL_751 , 693 , 1 ,  28 , 28 , 0
HonestReporter:  , H_UL_752 , 694 , 0.999952 ,  8 , 8 , 0
HonestReporter:  , H_UL_753 , 695 , 1 ,  18 , 18 , 0
HonestReporter:  , H_UL_754 , 696 , 0.872965 ,  2 , 2 , 0
HonestReporter:  , H_UL_755 , 697 , 1 ,  12 , 12 , 0
HonestReporter:  , H_UL_756 , 698 , 1 ,  23 , 23 , 0
HonestReporter:  , H_UL_758 , 699 , 1 ,  34 , 34 , 0
HonestReporter:  , H_UL_759 , 700 , 1 ,  13 , 13 , 0
HonestReporter:  , H_UL_760 , 701 , 1 ,  37 , 37 , 0
HonestReporter:  , H_UL_761 , 702 , 0.999319 ,  6 , 6 , 0
HonestReporter:  , H_UL_762 , 703 , 0.96385 ,  3 , 3 , 0
HonestReporter:  , H_UL_763 , 704 , 0.999999 ,  11 , 11 , 0
HonestReporter:  , H_UL_764 , 705 , 1 ,  17 , 17 , 0
HonestReporter:  , H_UL_766 , 706 , 1 ,  33 , 33 , 0
HonestReporter:  , H_UL_767 , 707 , 1 ,  30 , 30 , 0
HonestReporter:  , H_UL_769 , 708 , 1 ,  26 , 26 , 0
HonestReporter:  , H_UL_771 , 709 , 1 ,  22 , 22 , 0
HonestReporter:  , H_UL_772 , 710 , 1 ,  41 , 41 , 0
HonestReporter:  , H_UL_773 , 711 , 1 ,  47 , 47 , 0
HonestReporter:  , H_UL_774 , 712 , 0.612903 ,  1 , 1 , 0
HonestReporter:  , H_UL_775 , 713 , 0.612903 ,  1 , 1 , 0
HonestReporter:  , H_UL_776 , 714 , 1 ,  45 , 45 , 0
HonestReporter:  , H_UL_777 , 715 , 1 ,  17 , 17 , 0
HonestReporter:  , H_UL_778 , 716 , 0.999987 ,  9 , 9 , 0
HonestReporter:  , H_UL_780 , 717 , 1 ,  23 , 23 , 0
HonestReporter:  , H_UL_781 , 718 , 1 ,  41 , 41 , 0
HonestReporter:  , H_UL_783 , 719 , 0.999952 ,  8 , 8 , 0
HonestReporter:  , H_UL_784 , 720 , 0.999819 ,  7 , 7 , 0
HonestReporter:  , H_UL_787 , 721 , 1 ,  36 , 36 , 0
HonestReporter:  , H_UL_788 , 722 , 1 ,  14 , 14 , 0
HonestReporter:  , H_UL_790 , 723 , 0.990326 ,  4 , 4 , 0
HonestReporter:  , H_UL_791 , 724 , 0.999987 ,  9 , 9 , 0
HonestReporter:  , H_UL_793 , 725 , 1 ,  30 , 30 , 0
HonestReporter:  , H_UL_794 , 726 , 0.873189 ,  2 , 2 , 0
HonestReporter:  , H_UL_795 , 727 , 0.611111 ,  1 , 1 , 0
HonestReporter:  , H_UL_796 , 728 , 0.999951 ,  8 , 8 , 0
HonestReporter:  , H_UL_799 , 729 , 1 ,  16 , 16 , 0
HonestReporter:  , H_UL_800 , 730 , 0.873263 ,  2 , 2 , 0
HonestReporter:  , H_UL_801 , 731 , 0.871903 ,  2 , 2 , 0
HonestReporter:  , H_UL_802 , 732 , 0.872137 ,  2 , 2 , 0
HonestReporter:  , H_UL_803 , 733 , 0.999306 ,  6 , 6 , 0
HonestReporter:  , H_UL_804 , 734 , 1 ,  22 , 22 , 0
HonestReporter:  , H_UL_805 , 735 , 0.990187 ,  4 , 4 , 0
HonestReporter:  , H_UL_807 , 736 , 0.999987 ,  9 , 9 , 0
HonestReporter:  , H_UL_808 , 737 , 0.999999 ,  11 , 11 , 0
HonestReporter:  , H_UL_810 , 738 , 1 ,  48 , 48 , 0
HonestReporter:  , H_UL_811 , 739 , 1 ,  16 , 16 , 0
HonestReporter:  , H_UL_814 , 740 , 0.999322 ,  6 , 6 , 0
HonestReporter:  , H_UL_815 , 741 , 0.997408 ,  5 , 5 , 0
HonestReporter:  , H_UL_816 , 742 , 1 ,  29 , 29 , 0
HonestReporter:  , H_UL_817 , 743 , 1 ,  32 , 32 , 0
HonestReporter:  , H_UL_818 , 744 , 0.999999 ,  11 , 11 , 0
HonestReporter:  , H_UL_819 , 745 , 0.609948 ,  1 , 1 , 0
HonestReporter:  , H_UL_820 , 746 , 1 ,  16 , 16 , 0
HonestReporter:  , H_UL_821 , 747 , 1 ,  19 , 19 , 0
HonestReporter:  , H_UL_822 , 748 , 1 ,  42 , 42 , 0
HonestReporter:  , H_UL_826 , 749 , 0.999952 ,  8 , 8 , 0
HonestReporter:  , H_UL_827 , 750 , 1 ,  24 , 24 , 0
HonestReporter:  , H_UL_828 , 751 , 1 ,  20 , 20 , 0
HonestReporter:  , H_UL_829 , 752 , 1 ,  21 , 21 , 0
HonestReporter:  , H_UL_830 , 753 , 1 ,  13 , 13 , 0
HonestReporter:  , H_UL_831 , 754 , 1 ,  37 , 37 , 0
HonestReporter:  , H_UL_832 , 755 , 1 ,  22 , 22 , 0
HonestReporter:  , H_UL_833 , 756 , 0.999816 ,  7 , 7 , 0
HonestReporter:  , H_UL_835 , 757 , 0.964039 ,  3 , 3 , 0
HonestReporter:  , H_UL_836 , 758 , 1 ,  23 , 23 , 0
HonestReporter:  , H_UL_837 , 759 , 1 ,  26 , 26 , 0
HonestReporter:  , H_UL_838 , 760 , 1 ,  34 , 34 , 0
HonestReporter:  , H_UL_839 , 761 , 0.612903 ,  1 , 1 , 0
HonestReporter:  , H_UL_840 , 762 , 1 ,  23 , 23 , 0
HonestReporter:  , H_UL_842 , 763 , 0.997386 ,  5 , 5 , 0
HonestReporter:  , H_UL_843 , 764 , 1 ,  33 , 33 , 0
HonestReporter:  , H_UL_844 , 765 , 0.999999 ,  11 , 11 , 0
HonestReporter:  , H_UL_847 , 766 , 0.612903 ,  1 , 1 , 0
HonestReporter:  , H_UL_848 , 767 , 0.999997 ,  10 , 10 , 0
HonestReporter:  , H_UL_850 , 768 , 0.964143 ,  3 , 3 , 0
HonestReporter:  , H_UL_851 , 769 , 1 ,  12 , 12 , 0
HonestReporter:  , H_UL_854 , 770 , 0.990326 ,  4 , 4 , 0
HonestReporter:  , H_UL_855 , 771 , 1 ,  15 , 15 , 0
HonestReporter:  , H_UL_856 , 772 , 1 ,  23 , 23 , 0
HonestReporter:  , H_UL_857 , 773 , 1 ,  40 , 40 , 0
HonestReporter:  , H_UL_858 , 774 , 1 ,  23 , 23 , 0
HonestReporter:  , H_UL_859 , 775 , 1 ,  24 , 24 , 0
HonestReporter:  , H_UL_861 , 776 , 1 ,  41 , 41 , 0
HonestReporter:  , H_UL_863 , 777 , 0.999987 ,  9 , 9 , 0
HonestReporter:  , H_UL_864 , 778 , 1 ,  24 , 24 , 0
HonestReporter:  , H_UL_866 , 779 , 0.999951 ,  8 , 8 , 0
HonestReporter:  , H_UL_867 , 780 , 1 ,  14 , 14 , 0
HonestReporter:  , H_UL_868 , 781 , 1 ,  35 , 35 , 0
HonestReporter:  , H_UL_869 , 782 , 0.611111 ,  1 , 1 , 0
HonestReporter:  , H_UL_870 , 783 , 1 ,  14 , 14 , 0
HonestReporter:  , H_UL_871 , 784 , 0.964143 ,  3 , 3 , 0
HonestReporter:  , H_UL_873 , 785 , 1 ,  32 , 32 , 0
HonestReporter:  , H_UL_874 , 786 , 1 ,  16 , 16 , 0
HonestReporter:  , H_UL_875 , 787 , 0.999952 ,  8 , 8 , 0
HonestReporter:  , H_UL_876 , 788 , 1 ,  17 , 17 , 0
HonestReporter:  , H_UL_877 , 789 , 1 ,  40 , 40 , 0
HonestReporter:  , H_UL_878 , 790 , 0.873263 ,  2 , 2 , 0
HonestReporter:  , H_UL_879 , 791 , 1 ,  19 , 19 , 0
HonestReporter:  , H_UL_882 , 792 , 1 ,  17 , 17 , 0
HonestReporter:  , H_UL_884 , 793 , 1 ,  12 , 12 , 0
HonestReporter:  , H_UL_885 , 794 , 0.873189 ,  2 , 2 , 0
HonestReporter:  , H_UL_886 , 795 , 1 ,  43 , 43 , 0
HonestReporter:  , H_UL_887 , 796 , 1 ,  29 , 29 , 0
HonestReporter:  , H_UL_888 , 797 , 1 ,  29 , 29 , 0
HonestReporter:  , H_UL_889 , 798 , 1 ,  26 , 26 , 0
HonestReporter:  , H_UL_890 , 799 , 1 ,  40 , 40 , 0
HonestReporter:  , H_UL_892 , 800 , 0.612903 ,  1 , 1 , 0
HonestReporter:  , H_UL_893 , 801 , 0.612903 ,  1 , 1 , 0
HonestReporter:  , H_UL_894 , 802 , 1 ,  16 , 16 , 0
HonestReporter:  , H_UL_896 , 803 , 1 ,  30 , 30 , 0
HonestReporter:  , H_UL_899 , 804 , 0.999997 ,  10 , 10 , 0
HonestReporter:  , H_UR_993 , 805 , 1 ,  25 , 25 , 0
HonestReporter:  , H_UR_996 , 806 , 0.990215 ,  4 , 4 , 0
HonestReporter:  , H_UR_997 , 807 , 1 ,  28 , 28 , 0
HonestReporter:  , H_UR_998 , 808 , 1 ,  23 , 23 , 0
HonestReporter:  , H_UR_999 , 809 , 0.609948 ,  1 , 1 , 0
HonestReporter:  , H_UR_1001 , 810 , 1 ,  23 , 23 , 0
HonestReporter:  , H_UR_1002 , 811 , 0.9974 ,  5 , 5 , 0
HonestReporter:  , H_UR_1004 , 812 , 0.963806 ,  3 , 3 , 0
HonestReporter:  , H_UR_1005 , 813 , 1 ,  12 , 12 , 0
HonestReporter:  , H_UR_1006 , 814 , 0.872135 ,  2 , 2 , 0
HonestReporter:  , H_UR_1007 , 815 , 1 ,  29 , 29 , 0
HonestReporter:  , H_UR_1008 , 816 , 0.990218 ,  4 , 4 , 0
HonestReporter:  , H_UR_1009 , 817 , 1 ,  14 , 14 , 0
HonestReporter:  , H_UR_1011 , 818 , 1 ,  18 , 18 , 0
HonestReporter:  , H_UR_1012 , 819 , 0.963631 ,  3 , 3 , 0
HonestReporter:  , H_UR_1013 , 820 , 0.963761 ,  3 , 3 , 0
HonestReporter:  , H_UR_1014 , 821 , 0.999309 ,  6 , 6 , 0
HonestReporter:  , H_UR_1015 , 822 , 0.990179 ,  4 , 4 , 0
HonestReporter:  , H_UR_1016 , 823 , 0.997408 ,  5 , 5 , 0
HonestReporter:  , H_UR_1018 , 824 , 0.609819 ,  1 , 1 , 0
HonestReporter:  , H_UR_1019 , 825 , 0.963576 ,  3 , 3 , 0
HonestReporter:  , H_UR_1020 , 826 , 0.999815 ,  7 , 7 , 0
HonestReporter:  , H_UR_1025 , 827 , 0.999999 ,  11 , 11 , 0
HonestReporter:  , H_UR_1026 , 828 , 0.871757 ,  2 , 2 , 0
HonestReporter:  , H_UR_1032 , 829 , 0.871211 ,  2 , 2 , 0
HonestReporter:  , H_UR_1034 , 830 , 0.999952 ,  8 , 8 , 0
HonestReporter:  , H_UR_1038 , 831 , 0.871498 ,  2 , 2 , 0
HonestReporter:  , H_UR_1043 , 832 , 0.963806 ,  3 , 3 , 0
HonestReporter:  , H_UR_1046 , 833 , 0.609819 ,  1 , 1 , 0
HonestReporter:  , H_UR_1049 , 834 , 0.999987 ,  9 , 9 , 0
HonestReporter:  , H_UR_1050 , 835 , 0.609948 ,  1 , 1 , 0
HonestReporter:  , H_UR_1051 , 836 , 0.963576 ,  3 , 3 , 0
HonestReporter:  , H_UR_1053 , 837 , 0.871211 ,  2 , 2 , 0
HonestReporter:  , H_UR_1054 , 838 , 0.997379 ,  5 , 5 , 0
HonestReporter:  , H_UR_1055 , 839 , 0.609948 ,  1 , 1 , 0
HonestReporter:  , H_UR_1056 , 840 , 1 ,  26 , 26 , 0
HonestReporter:  , H_UR_1057 , 841 , 0.609948 ,  1 , 1 , 0
HonestReporter:  , H_UR_1058 , 842 , 0.871806 ,  2 , 2 , 0
HonestReporter:  , H_UR_1059 , 843 , 1 ,  12 , 12 , 0
HonestReporter:  , H_UR_1062 , 844 , 0.999987 ,  9 , 9 , 0
HonestReporter:  , H_UR_1064 , 845 , 0.999817 ,  7 , 7 , 0
HonestReporter:  , H_UR_1065 , 846 , 0.997389 ,  5 , 5 , 0
HonestReporter:  , H_UR_1068 , 847 , 1 ,  30 , 30 , 0
HonestReporter:  , H_UR_1069 , 848 , 0.609948 ,  1 , 1 , 0
HonestReporter:  , H_UR_1072 , 849 , 0.997379 ,  5 , 5 , 0
HonestReporter:  , H_UR_1073 , 850 , 0.872135 ,  2 , 2 , 0
HonestReporter:  , H_UR_1074 , 851 , 0.999818 ,  7 , 7 , 0
HonestReporter:  , H_UR_1075 , 852 , 0.872135 ,  2 , 2 , 0
HonestReporter:  , H_UR_1077 , 853 , 1 ,  22 , 22 , 0
HonestReporter:  , H_UR_1078 , 854 , 1 ,  15 , 15 , 0
HonestReporter:  , H_UR_1079 , 855 , 0.872135 ,  2 , 2 , 0
HonestReporter:  , H_UR_1082 , 856 , 0.999987 ,  9 , 9 , 0
HonestReporter:  , H_UR_1083 , 857 , 1 ,  15 , 15 , 0
HonestReporter:  , H_UR_1085 , 858 , 0.872135 ,  2 , 2 , 0
HonestReporter:  , H_UR_1086 , 859 , 0.999315 ,  6 , 6 , 0
HonestReporter:  , H_UR_1089 , 860 , 0.990138 ,  4 , 4 , 0
HonestReporter:  , H_UR_1090 , 861 , 1 ,  12 , 12 , 0
HonestReporter:  , H_UR_1092 , 862 , 0.871991 ,  2 , 2 , 0
HonestReporter:  , H_UR_1093 , 863 , 0.990232 ,  4 , 4 , 0
HonestReporter:  , H_UR_1094 , 864 , 1 ,  13 , 13 , 0
HonestReporter:  , H_UR_1096 , 865 , 0.999309 ,  6 , 6 , 0
HonestReporter:  , H_UR_1097 , 866 , 0.963806 ,  3 , 3 , 0
HonestReporter:  , H_UR_1098 , 867 , 1 ,  33 , 33 , 0
HonestReporter:  , H_UR_1099 , 868 , 0.609819 ,  1 , 1 , 0
HonestReporter:  , H_UR_1101 , 869 , 0.9639 ,  3 , 3 , 0
HonestReporter:  , H_UR_1102 , 870 , 1 ,  23 , 23 , 0
HonestReporter:  , H_UR_1103 , 871 , 0.963576 ,  3 , 3 , 0
HonestReporter:  , H_UR_1105 , 872 , 1 ,  30 , 30 , 0
HonestReporter:  , H_UR_1107 , 873 , 0.990156 ,  4 , 4 , 0
HonestReporter:  , H_UR_1109 , 874 , 1 ,  15 , 15 , 0
HonestReporter:  , H_UR_1110 , 875 , 0.997405 ,  5 , 5 , 0
HonestReporter:  , H_UR_1111 , 876 , 1 ,  26 , 26 , 0
HonestReporter:  , H_UR_1112 , 877 , 0.610966 ,  1 , 1 , 0
HonestReporter:  , H_UR_1115 , 878 , 0.999816 ,  7 , 7 , 0
HonestReporter:  , H_UR_1116 , 879 , 0.872366 ,  2 , 2 , 0
HonestReporter:  , H_UR_1118 , 880 , 0.999817 ,  7 , 7 , 0
HonestReporter:  , H_UR_1123 , 881 , 1 ,  22 , 22 , 0
HonestReporter:  , H_UR_1124 , 882 , 1 ,  14 , 14 , 0
HonestReporter:  , H_UR_1125 , 883 , 1 ,  31 , 31 , 0
HonestReporter:  , H_UR_1127 , 884 , 0.871757 ,  2 , 2 , 0
HonestReporter:  , H_UR_1128 , 885 , 0.609819 ,  1 , 1 , 0
HonestReporter:  , H_UR_1129 , 886 , 0.999951 ,  8 , 8 , 0
HonestReporter:  , H_UR_1131 , 887 , 0.963872 ,  3 , 3 , 0
HonestReporter:  , H_UR_1135 , 888 , 0.609948 ,  1 , 1 , 0
HonestReporter:  , H_UR_1136 , 889 , 0.997379 ,  5 , 5 , 0
HonestReporter:  , H_UR_1137 , 890 , 0.872135 ,  2 , 2 , 0
HonestReporter:  , H_UR_1145 , 891 , 1 ,  12 , 12 , 0
HonestReporter:  , H_UR_1146 , 892 , 0.872135 ,  2 , 2 , 0
HonestReporter:  , H_UR_1149 , 893 , 1 ,  13 , 13 , 0
HonestReporter:  , H_UR_1151 , 894 , 0.610966 ,  1 , 1 , 0
HonestReporter:  , H_UR_1152 , 895 , 0.990162 ,  4 , 4 , 0
HonestReporter:  , H_UR_1154 , 896 , 0.610966 ,  1 , 1 , 0
HonestReporter:  , H_UR_1157 , 897 , 0.963615 ,  3 , 3 , 0
HonestReporter:  , H_UR_1158 , 898 , 0.999999 ,  11 , 11 , 0
HonestReporter:  , H_UR_1161 , 899 , 1 ,  18 , 18 , 0
HonestReporter:  , H_UR_1162 , 900 , 1 ,  12 , 12 , 0
HonestReporter:  , H_UR_1163 , 901 , 1 ,  30 , 30 , 0
HonestReporter:  , H_UR_1165 , 902 , 0.999987 ,  9 , 9 , 0
HonestReporter:  , H_UR_1167 , 903 , 0.871991 ,  2 , 2 , 0
HonestReporter:  , H_UR_1169 , 904 , 0.963806 ,  3 , 3 , 0
HonestReporter:  , H_UR_1173 , 905 , 0.963806 ,  3 , 3 , 0
HonestReporter:  , H_UR_1176 , 906 , 1 ,  27 , 27 , 0
HonestReporter:  , H_UR_1178 , 907 , 0.609819 ,  1 , 1 , 0
HonestReporter:  , H_UR_1179 , 908 , 0.963491 ,  3 , 3 , 0
HonestReporter:  , H_UR_1181 , 909 , 0.997391 ,  5 , 5 , 0
HonestReporter:  , H_UR_1182 , 910 , 0.990215 ,  4 , 4 , 0
HonestReporter:  , H_UR_1184 , 911 , 1 ,  28 , 28 , 0
HonestReporter:  , H_UR_1185 , 912 , 0.990138 ,  4 , 4 , 0
HonestReporter:  , H_UR_1187 , 913 , 0.871806 ,  2 , 2 , 0
HonestReporter:  , H_UR_1188 , 914 , 1 ,  31 , 31 , 0
HonestReporter:  , H_UR_1189 , 915 , 0.999308 ,  6 , 6 , 0
HonestReporter:  , H_UR_1192 , 916 , 0.997418 ,  5 , 5 , 0
HonestReporter:  , H_UR_1193 , 917 , 0.999987 ,  9 , 9 , 0
HonestReporter:  , H_UR_1194 , 918 , 0.997379 ,  5 , 5 , 0
HonestReporter:  , H_UR_1195 , 919 , 0.609819 ,  1 , 1 , 0
