SelfishReporter:  , S_LL_30 , 95 , 0.739953 , 52 ,  28 , 24
SelfishReporter:  , S_LL_31 , 96 , 0.998894 , 52 ,  31 , 21
SelfishReporter:  , S_LL_32 , 97 , 0.999181 , 44 ,  27 , 17
SelfishReporter:  , S_LL_33 , 98 , 0.999966 , 23 ,  18 , 5
SelfishReporter:  , S_LL_34 , 99 , 0.999808 , 65 ,  39 , 26
SelfishReporter:  , S_LL_35 , 100 , -0.75802 , 52 ,  25 , 27
SelfishReporter:  , S_LL_36 , 101 , -0.4538 , 52 ,  26 , 26
SelfishReporter:  , S_LL_37 , 102 , 0.141644 , 39 ,  20 , 19
SelfishReporter:  , S_LL_38 , 103 , -0.997841 , 68 ,  31 , 37
SelfishReporter:  , S_LL_39 , 104 , 0.999999 , 51 ,  34 , 17
SelfishReporter:  , S_LL_40 , 105 , -0.991453 , 16 ,  5 , 11
SelfishReporter:  , S_LL_41 , 106 , 0.990267 , 56 ,  32 , 24
SelfishReporter:  , S_LL_42 , 107 , 0.400876 , 33 ,  17 , 16
SelfishReporter:  , S_LL_43 , 108 , 0.999993 , 71 ,  43 , 28
SelfishReporter:  , S_LL_44 , 109 , 0.0200213 , 38 ,  19 , 19
SelfishReporter:  , S_LL_45 , 110 , -0.998677 , 45 ,  19 , 26
SelfishReporter:  , S_LL_46 , 111 , 0.944264 , 12 ,  8 , 4
SelfishReporter:  , S_LL_47 , 112 , 0.79473 , 62 ,  33 , 29
SelfishReporter:  , S_LL_48 , 113 , 0.999999 , 78 ,  48 , 30
SelfishReporter:  , S_LL_49 , 114 , 0.998193 , 70 ,  40 , 30
SelfishReporter:  , S_LL_50 , 115 , -0.425652 , 5 ,  2 , 3
SelfishReporter:  , S_LL_51 , 116 , 0.945541 , 53 ,  29 , 24
SelfishReporter:  , S_LL_52 , 117 , 0.979915 , 47 ,  27 , 20
SelfishReporter:  , S_LL_53 , 118 , 0.996927 , 49 ,  28 , 21
SelfishReporter:  , S_LL_54 , 119 , 0.916916 , 24 ,  14 , 10
SelfishReporter:  , S_LL_55 , 120 , 0.999992 , 62 ,  39 , 23
SelfishReporter:  , S_LL_56 , 121 , 0.627334 , 61 ,  32 , 29
SelfishReporter:  , S_LL_57 , 122 , 0.852683 , 45 ,  24 , 21
SelfishReporter:  , S_LL_58 , 123 , -0.875579 , 37 ,  17 , 20
SelfishReporter:  , S_LL_59 , 124 , 0.995729 , 48 ,  28 , 20
SelfishReporter:  , S_LL_60 , 125 , -0.851788 , 63 ,  31 , 32
SelfishReporter:  , S_LL_61 , 126 , 0.853424 , 9 ,  6 , 3
SelfishReporter:  , S_LL_62 , 127 , 0.228541 , 41 ,  21 , 20
SelfishReporter:  , S_LL_63 , 128 , 0.999306 , 67 ,  39 , 28
SelfishReporter:  , S_LL_64 , 129 , 0.999981 , 56 ,  35 , 21
SelfishReporter:  , S_LL_65 , 130 , 0.708602 , 56 ,  30 , 26
SelfishReporter:  , S_LL_66 , 131 , 0.999997 , 48 ,  32 , 16
SelfishReporter:  , S_LL_67 , 132 , 0.598739 , 50 ,  27 , 23
SelfishReporter:  , S_LL_68 , 133 , 0.831412 , 27 ,  15 , 12
SelfishReporter:  , S_LL_69 , 134 , 0.879256 , 48 ,  26 , 22
SelfishReporter:  , S_LR_230 , 135 , 0.967787 , 35 ,  20 , 15
SelfishReporter:  , S_LR_231 , 136 , 0.72677 , 16 ,  9 , 7
SelfishReporter:  , S_LR_233 , 137 , 0.424848 , 5 ,  3 , 2
SelfishReporter:  , S_LR_234 , 138 , 0.951292 , 14 ,  9 , 5
SelfishReporter:  , S_LR_235 , 139 , 0.950049 , 10 ,  7 , 3
SelfishReporter:  , S_LR_236 , 140 , 0.950333 , 6 ,  5 , 1
SelfishReporter:  , S_LR_237 , 141 , 0.992337 , 26 ,  16 , 10
SelfishReporter:  , S_LR_238 , 142 , 0.951465 , 12 ,  8 , 4
SelfishReporter:  , S_LR_239 , 143 , 0.979903 , 9 ,  7 , 2
SelfishReporter:  , S_LR_240 , 144 , 0.951049 , 10 ,  7 , 3
SelfishReporter:  , S_LR_241 , 145 , -0.716284 , 20 ,  9 , 11
SelfishReporter:  , S_LR_242 , 146 , -0.880394 , 9 ,  3 , 6
SelfishReporter:  , S_LR_243 , 147 , -0.725564 , 2 ,  0 , 2
SelfishReporter:  , S_LR_244 , 148 , 0.999661 , 38 ,  24 , 14
SelfishReporter:  , S_LR_246 , 149 , 0.980106 , 13 ,  9 , 4
SelfishReporter:  , S_LR_248 , 150 , -0.42655 , 3 ,  1 , 2
SelfishReporter:  , S_LR_250 , 151 , 0.724563 , 10 ,  6 , 4
SelfishReporter:  , S_LR_252 , 152 , 0.980743 , 21 ,  13 , 8
SelfishReporter:  , S_LR_253 , 153 , -0.45 , 1 ,  0 , 1
SelfishReporter:  , S_LR_254 , 154 , 0.998724 , 24 ,  16 , 8
SelfishReporter:  , S_LR_255 , 155 , 0.433189 , 7 ,  4 , 3
SelfishReporter:  , S_LR_256 , 156 , 0.999918 , 17 ,  14 , 3
SelfishReporter:  , S_LR_257 , 157 , 0.992284 , 28 ,  17 , 11
SelfishReporter:  , S_LR_259 , 158 , 0.00559786 , 16 ,  8 , 8
SelfishReporter:  , S_LR_261 , 159 , 0.726696 , 4 ,  3 , 1
SelfishReporter:  , S_LR_262 , 160 , 0.999961 , 20 ,  16 , 4
SelfishReporter:  , S_LR_263 , 161 , 0.88002 , 5 ,  4 , 1
SelfishReporter:  , S_LR_265 , 162 , 0.97707 , 21 ,  13 , 8
SelfishReporter:  , S_LR_266 , 163 , 0.883693 , 13 ,  8 , 5
SelfishReporter:  , S_LR_268 , 164 , 0.941988 , 12 ,  8 , 4
SelfishReporter:  , S_LR_269 , 165 , 0.998491 , 32 ,  20 , 12
SelfishReporter:  , S_UL_431 , 166 , -0.418201 , 13 ,  6 , 7
SelfishReporter:  , S_UL_432 , 167 , 0.421865 , 5 ,  3 , 2
SelfishReporter:  , S_UL_433 , 168 , 0.440261 , 21 ,  11 , 10
SelfishReporter:  , S_UL_434 , 169 , -0.426498 , 3 ,  1 , 2
SelfishReporter:  , S_UL_435 , 170 , 0.999994 , 24 ,  19 , 5
SelfishReporter:  , S_UL_436 , 171 , 0.950681 , 32 ,  18 , 14
SelfishReporter:  , S_UL_437 , 172 , -0.880272 , 7 ,  2 , 5
SelfishReporter:  , S_UL_438 , 173 , 0.428553 , 15 ,  8 , 7
SelfishReporter:  , S_UL_439 , 174 , 0.725317 , 36 ,  19 , 17
SelfishReporter:  , S_UL_440 , 175 , 0.949295 , 14 ,  9 , 5
SelfishReporter:  , S_UL_441 , 176 , -0.00812871 , 6 ,  3 , 3
SelfishReporter:  , S_UL_442 , 177 , 0.996832 , 23 ,  15 , 8
SelfishReporter:  , S_UL_443 , 178 , 0.975798 , 25 ,  15 , 10
SelfishReporter:  , S_UL_444 , 179 , 0.884618 , 23 ,  13 , 10
SelfishReporter:  , S_UL_445 , 180 , -0.434027 , 7 ,  3 , 4
SelfishReporter:  , S_UL_446 , 181 , 0.885003 , 41 ,  22 , 19
SelfishReporter:  , S_UL_448 , 182 , 0.975515 , 47 ,  26 , 21
SelfishReporter:  , S_UL_451 , 183 , 0.879837 , 23 ,  13 , 10
SelfishReporter:  , S_UL_452 , 184 , 0.717138 , 8 ,  5 , 3
SelfishReporter:  , S_UL_453 , 185 , 0.975051 , 33 ,  19 , 14
SelfishReporter:  , S_UL_454 , 186 , 0.852791 , 23 ,  13 , 10
SelfishReporter:  , S_UL_455 , 187 , -9.35483e-05 , 8 ,  4 , 4
SelfishReporter:  , S_UL_458 , 188 , 0.449339 , 1 ,  1 , 0
SelfishReporter:  , S_UL_459 , 189 , -0.949947 , 4 ,  0 , 4
SelfishReporter:  , S_UL_460 , 190 , 0.687065 , 52 ,  27 , 25
SelfishReporter:  , S_UL_461 , 191 , 0.979953 , 43 ,  24 , 19
SelfishReporter:  , S_UL_462 , 192 , -0.431968 , 11 ,  5 , 6
SelfishReporter:  , S_UL_463 , 193 , 0.999364 , 29 ,  19 , 10
SelfishReporter:  , S_UL_464 , 194 , -0.727797 , 14 ,  6 , 8
SelfishReporter:  , S_UL_466 , 195 , -0.997411 , 31 ,  12 , 19
SelfishReporter:  , S_UL_467 , 196 , -0.42638 , 3 ,  1 , 2
SelfishReporter:  , S_UL_468 , 197 , 0.428664 , 7 ,  4 , 3
SelfishReporter:  , S_UL_469 , 198 , 0.428919 , 3 ,  2 , 1
SelfishReporter:  , S_UR_630 , 199 , 0.951051 , 14 ,  9 , 5
SelfishReporter:  , S_UR_631 , 200 , 0.883686 , 29 ,  16 , 13
SelfishReporter:  , S_UR_632 , 201 , -0.434698 , 3 ,  1 , 2
SelfishReporter:  , S_UR_634 , 202 , -0.431114 , 3 ,  1 , 2
SelfishReporter:  , S_UR_636 , 203 , -0.00666063 , 10 ,  5 , 5
SelfishReporter:  , S_UR_637 , 204 , 0.991934 , 18 ,  12 , 6
SelfishReporter:  , S_UR_640 , 205 , 0.720262 , 10 ,  6 , 4
SelfishReporter:  , S_UR_641 , 206 , 0.425337 , 3 ,  2 , 1
SelfishReporter:  , S_UR_642 , 207 , 0.431003 , 3 ,  2 , 1
SelfishReporter:  , S_UR_643 , 208 , -0.00551068 , 2 ,  1 , 1
SelfishReporter:  , S_UR_645 , 209 , -0.880356 , 5 ,  1 , 4
SelfishReporter:  , S_UR_646 , 210 , 0.855132 , 35 ,  19 , 16
SelfishReporter:  , S_UR_648 , 211 , 0.720328 , 14 ,  8 , 6
SelfishReporter:  , S_UR_650 , 212 , -0.726876 , 2 ,  0 , 2
SelfishReporter:  , S_UR_652 , 213 , 0.447699 , 1 ,  1 , 0
SelfishReporter:  , S_UR_653 , 214 , 0.949145 , 6 ,  5 , 1
SelfishReporter:  , S_UR_654 , 215 , 0.996716 , 15 ,  11 , 4
SelfishReporter:  , S_UR_655 , 216 , 0.428728 , 11 ,  6 , 5
SelfishReporter:  , S_UR_657 , 217 , -0.00819314 , 16 ,  8 , 8
SelfishReporter:  , S_UR_659 , 218 , -0.439125 , 5 ,  2 , 3
SelfishReporter:  , S_UR_662 , 219 , 0.719284 , 4 ,  3 , 1
SelfishReporter:  , S_UR_663 , 220 , -0.42856 , 3 ,  1 , 2
SelfishReporter:  , S_UR_669 , 221 , 0.00596545 , 14 ,  7 , 7
