Reporter_0_0.25:  , M_LL_0 , 1 , -1 ,  41 , 4 , 37
Reporter_0_0.25:  , M_LL_1 , 2 , -1 ,  52 , 0 , 52
Reporter_0_0.25:  , M_LL_2 , 3 , -1 ,  55 , 1 , 54
Reporter_0_0.25:  , M_LL_3 , 4 , -1 ,  58 , 3 , 55
Reporter_0_0.25:  , M_LL_4 , 5 , -1 ,  55 , 1 , 54
Reporter_0_0.25:  , M_LL_5 , 6 , -1 ,  58 , 2 , 56
Reporter_0_0.25:  , M_LL_6 , 7 , -1 ,  44 , 4 , 40
Reporter_0_0.25:  , M_LL_7 , 8 , -1 ,  22 , 0 , 22
Reporter_0_0.25:  , M_LL_8 , 9 , -1 ,  69 , 5 , 64
Reporter_0_0.25:  , M_LL_9 , 10 , -1 ,  58 , 1 , 57
Reporter_0_0.25:  , M_LL_10 , 11 , -1 ,  21 , 1 , 20
Reporter_0_0.25:  , M_LL_11 , 12 , -1 ,  36 , 2 , 34
Reporter_0_0.25:  , M_LL_12 , 13 , -1 ,  54 , 2 , 52
Reporter_0_0.25:  , M_LL_13 , 14 , -1 ,  46 , 4 , 42
Reporter_0_0.25:  , M_LL_14 , 15 , -1 ,  45 , 3 , 42
Reporter_0_0.25:  , M_LL_15 , 16 , -1 ,  23 , 1 , 22
Reporter_0_0.25:  , M_LL_16 , 17 , -1 ,  33 , 2 , 31
Reporter_0_0.25:  , M_LL_17 , 18 , -1 ,  52 , 2 , 50
Reporter_0_0.25:  , M_LL_18 , 19 , -1 ,  58 , 3 , 55
Reporter_0_0.25:  , M_LL_19 , 20 , -1 ,  40 , 2 , 38
Reporter_0_0.25:  , M_LL_20 , 21 , -1 ,  54 , 2 , 52
Reporter_0_0.25:  , M_LL_21 , 22 , -1 ,  47 , 4 , 43
Reporter_0_0.25:  , M_LL_22 , 23 , -1 ,  45 , 3 , 42
Reporter_0_0.25:  , M_LL_23 , 24 , -1 ,  31 , 1 , 30
Reporter_0_0.25:  , M_LL_24 , 25 , -1 ,  43 , 2 , 41
Reporter_0_0.25:  , M_LL_25 , 26 , -1 ,  42 , 4 , 38
Reporter_0_0.25:  , M_LL_26 , 27 , -1 ,  30 , 0 , 30
Reporter_0_0.25:  , M_LL_27 , 28 , -1 ,  65 , 3 , 62
Reporter_0_0.25:  , M_LL_28 , 29 , -1 ,  22 , 0 , 22
Reporter_0_0.25:  , M_LL_29 , 30 , -1 ,  56 , 3 , 53
Reporter_0_0.25:  , M_LR_200 , 201 , -0.879008 ,  3 , 0 , 3
Reporter_0_0.25:  , M_LR_201 , 202 , -0.999465 ,  11 , 1 , 10
Reporter_0_0.25:  , M_LR_202 , 203 , -1 ,  32 , 0 , 32
Reporter_0_0.25:  , M_LR_204 , 204 , -0.878767 ,  5 , 1 , 4
Reporter_0_0.25:  , M_LR_205 , 205 , -0.999787 ,  10 , 0 , 10
Reporter_0_0.25:  , M_LR_206 , 206 , -0.878558 ,  5 , 1 , 4
Reporter_0_0.25:  , M_LR_207 , 207 , -0.999986 ,  13 , 0 , 13
Reporter_0_0.25:  , M_LR_208 , 208 , -0.996692 ,  11 , 2 , 9
Reporter_0_0.25:  , M_LR_210 , 209 , -0.979615 ,  5 , 0 , 5
Reporter_0_0.25:  , M_LR_212 , 210 , -0.450644 ,  1 , 0 , 1
Reporter_0_0.25:  , M_LR_214 , 211 , -0.45 ,  1 , 0 , 1
Reporter_0_0.25:  , M_LR_215 , 212 , -0.45 ,  1 , 0 , 1
Reporter_0_0.25:  , M_LR_216 , 213 , -1 ,  41 , 0 , 41
Reporter_0_0.25:  , M_LR_217 , 214 , -1 ,  29 , 3 , 26
Reporter_0_0.25:  , M_LR_218 , 215 , -0.45 ,  1 , 0 , 1
Reporter_0_0.25:  , M_LR_219 , 216 , -0.999789 ,  10 , 0 , 10
Reporter_0_0.25:  , M_LR_220 , 217 , -1 ,  35 , 1 , 34
Reporter_0_0.25:  , M_LR_222 , 218 , -1 ,  35 , 2 , 33
Reporter_0_0.25:  , M_LR_223 , 219 , -1 ,  20 , 0 , 20
Reporter_0_0.25:  , M_LR_224 , 220 , -0.725564 ,  2 , 0 , 2
Reporter_0_0.25:  , M_LR_226 , 221 , -1 ,  36 , 5 , 31
Reporter_0_0.25:  , M_LR_227 , 222 , -0.991727 ,  6 , 0 , 6
Reporter_0_0.25:  , M_LR_228 , 223 , -0.725564 ,  2 , 0 , 2
Reporter_0_0.25:  , M_LR_229 , 224 , -1 ,  38 , 1 , 37
Reporter_0_0.25:  , S_LR_243 , 237 , -0.725564 ,  2 , 0 , 2
Reporter_0_0.25:  , S_LR_253 , 243 , -0.45 ,  1 , 0 , 1
Reporter_0_0.25:  , M_UL_400 , 341 , -0.999466 ,  9 , 0 , 9
Reporter_0_0.25:  , M_UL_401 , 342 , -1 ,  32 , 1 , 31
Reporter_0_0.25:  , M_UL_403 , 343 , -0.999915 ,  11 , 0 , 11
Reporter_0_0.25:  , M_UL_404 , 344 , -1 ,  17 , 0 , 17
Reporter_0_0.25:  , M_UL_405 , 345 , -0.998694 ,  10 , 1 , 9
Reporter_0_0.25:  , M_UL_406 , 346 , -1 ,  21 , 2 , 19
Reporter_0_0.25:  , M_UL_408 , 347 , -0.991813 ,  6 , 0 , 6
Reporter_0_0.25:  , M_UL_410 , 348 , -1 ,  17 , 0 , 17
Reporter_0_0.25:  , M_UL_411 , 349 , -0.996675 ,  7 , 0 , 7
Reporter_0_0.25:  , M_UL_412 , 350 , -0.880179 ,  3 , 0 , 3
Reporter_0_0.25:  , M_UL_413 , 351 , -0.999914 ,  13 , 1 , 12
Reporter_0_0.25:  , M_UL_415 , 352 , -0.446927 ,  1 , 0 , 1
Reporter_0_0.25:  , M_UL_418 , 353 , -0.451613 ,  1 , 0 , 1
Reporter_0_0.25:  , M_UL_421 , 354 , -0.878102 ,  3 , 0 , 3
Reporter_0_0.25:  , M_UL_422 , 355 , -0.999999 ,  20 , 2 , 18
Reporter_0_0.25:  , M_UL_424 , 356 , -0.998669 ,  8 , 0 , 8
Reporter_0_0.25:  , M_UL_426 , 357 , -0.999999 ,  18 , 1 , 17
Reporter_0_0.25:  , M_UL_427 , 358 , -0.723562 ,  2 , 0 , 2
Reporter_0_0.25:  , M_UL_428 , 359 , -1 ,  44 , 6 , 38
Reporter_0_0.25:  , M_UL_429 , 360 , -0.999474 ,  9 , 0 , 9
Reporter_0_0.25:  , S_UL_459 , 384 , -0.949947 ,  4 , 0 , 4
Reporter_0_0.25:  , M_UR_600 , 491 , -0.452282 ,  1 , 0 , 1
Reporter_0_0.25:  , M_UR_602 , 492 , -0.999473 ,  11 , 1 , 10
Reporter_0_0.25:  , M_UR_604 , 493 , -0.999999 ,  16 , 0 , 16
Reporter_0_0.25:  , M_UR_606 , 495 , -0.452282 ,  1 , 0 , 1
Reporter_0_0.25:  , M_UR_607 , 496 , -0.999986 ,  13 , 0 , 13
Reporter_0_0.25:  , M_UR_609 , 497 , -0.999916 ,  11 , 0 , 11
Reporter_0_0.25:  , M_UR_611 , 498 , -0.999995 ,  16 , 1 , 15
Reporter_0_0.25:  , M_UR_612 , 499 , -0.99979 ,  10 , 0 , 10
Reporter_0_0.25:  , M_UR_614 , 500 , -0.881152 ,  3 , 0 , 3
Reporter_0_0.25:  , M_UR_616 , 501 , -0.949961 ,  4 , 0 , 4
Reporter_0_0.25:  , M_UR_618 , 502 , -0.728309 ,  2 , 0 , 2
Reporter_0_0.25:  , M_UR_619 , 503 , -0.999986 ,  15 , 1 , 14
Reporter_0_0.25:  , M_UR_621 , 504 , -0.879013 ,  3 , 0 , 3
Reporter_0_0.25:  , M_UR_622 , 505 , -0.452282 ,  1 , 0 , 1
Reporter_0_0.25:  , M_UR_623 , 506 , -0.452282 ,  1 , 0 , 1
Reporter_0_0.25:  , M_UR_624 , 507 , -0.999998 ,  17 , 1 , 16
Reporter_0_0.25:  , M_UR_625 , 508 , -0.879013 ,  3 , 0 , 3
Reporter_0_0.25:  , M_UR_628 , 509 , -0.726876 ,  2 , 0 , 2
Reporter_0_0.25:  , M_UR_629 , 510 , -1 ,  22 , 0 , 22
Reporter_0_0.25:  , S_UR_645 , 521 , -0.880356 ,  5 , 1 , 4
Reporter_0_0.25:  , S_UR_650 , 524 , -0.726876 ,  2 , 0 , 2
