SelfishReporter: , S_LL_30 , 95 , -0.58844 , 52 ,  28 , 24
SelfishReporter: , S_LL_31 , 96 , -0.517162 , 52 ,  31 , 21
SelfishReporter: , S_LL_32 , 97 , -0.558785 , 44 ,  27 , 17
SelfishReporter: , S_LL_33 , 98 , -0.299243 , 23 ,  18 , 5
SelfishReporter: , S_LL_34 , 99 , -0.570802 , 65 ,  39 , 26
SelfishReporter: , S_LL_35 , 100 , -0.621697 , 52 ,  25 , 27
SelfishReporter: , S_LL_36 , 101 , -0.62664 , 52 ,  26 , 26
SelfishReporter: , S_LL_37 , 102 , -0.519606 , 39 ,  20 , 19
SelfishReporter: , S_LL_38 , 103 , -0.752614 , 68 ,  31 , 37
SelfishReporter: , S_LL_39 , 104 , -0.431908 , 51 ,  34 , 17
SelfishReporter: , S_LL_40 , 105 , -0.433716 , 16 ,  5 , 11
SelfishReporter: , S_LL_41 , 106 , -0.595059 , 56 ,  32 , 24
SelfishReporter: , S_LL_42 , 107 , -0.470708 , 33 ,  17 , 16
SelfishReporter: , S_LL_43 , 108 , -0.888548 , 71 ,  43 , 28
SelfishReporter: , S_LL_44 , 109 , -0.512176 , 38 ,  19 , 19
SelfishReporter: , S_LL_45 , 110 , -0.633869 , 45 ,  19 , 26
SelfishReporter: , S_LL_46 , 111 , -0.315533 , 12 ,  8 , 4
SelfishReporter: , S_LL_47 , 112 , -0.633044 , 62 ,  33 , 29
SelfishReporter: , S_LL_48 , 113 , -0.616679 , 78 ,  48 , 30
SelfishReporter: , S_LL_49 , 114 , -0.62826 , 70 ,  40 , 30
SelfishReporter: , S_LL_50 , 115 , -0.319247 , 5 ,  2 , 3
SelfishReporter: , S_LL_51 , 116 , -0.566372 , 53 ,  29 , 24
SelfishReporter: , S_LL_52 , 117 , -0.511393 , 47 ,  27 , 20
SelfishReporter: , S_LL_53 , 118 , -0.50945 , 49 ,  28 , 21
SelfishReporter: , S_LL_54 , 119 , -0.386596 , 24 ,  14 , 10
SelfishReporter: , S_LL_55 , 120 , -0.583239 , 62 ,  39 , 23
SelfishReporter: , S_LL_56 , 121 , -0.635258 , 61 ,  32 , 29
SelfishReporter: , S_LL_57 , 122 , -0.527518 , 45 ,  24 , 21
SelfishReporter: , S_LL_58 , 123 , -0.536957 , 37 ,  17 , 20
SelfishReporter: , S_LL_59 , 124 , -0.514013 , 48 ,  28 , 20
SelfishReporter: , S_LL_60 , 125 , -0.686166 , 63 ,  31 , 32
SelfishReporter: , S_LL_61 , 126 , -0.306873 , 9 ,  6 , 3
SelfishReporter: , S_LL_62 , 127 , -0.524451 , 41 ,  21 , 20
SelfishReporter: , S_LL_63 , 128 , -0.606602 , 67 ,  39 , 28
SelfishReporter: , S_LL_64 , 129 , -0.520332 , 56 ,  35 , 21
SelfishReporter: , S_LL_65 , 130 , -0.599371 , 56 ,  30 , 26
SelfishReporter: , S_LL_66 , 131 , -0.418871 , 48 ,  32 , 16
SelfishReporter: , S_LL_67 , 132 , -0.567197 , 50 ,  27 , 23
SelfishReporter: , S_LL_68 , 133 , -0.413858 , 27 ,  15 , 12
SelfishReporter: , S_LL_69 , 134 , -0.562742 , 48 ,  26 , 22
SelfishReporter: , S_LR_230 , 135 , -0.444661 , 35 ,  20 , 15
SelfishReporter: , S_LR_231 , 136 , -0.35434 , 16 ,  9 , 7
SelfishReporter: , S_LR_233 , 137 , -0.301361 , 5 ,  3 , 2
SelfishReporter: , S_LR_234 , 138 , -0.324023 , 14 ,  9 , 5
SelfishReporter: , S_LR_235 , 139 , -0.302017 , 10 ,  7 , 3
SelfishReporter: , S_LR_236 , 140 , 0.226998 , 6 ,  5 , 1
SelfishReporter: , S_LR_237 , 141 , -0.374884 , 26 ,  16 , 10
SelfishReporter: , S_LR_238 , 142 , -0.312793 , 12 ,  8 , 4
SelfishReporter: , S_LR_239 , 143 , -0.288018 , 9 ,  7 , 2
SelfishReporter: , S_LR_240 , 144 , -0.301914 , 10 ,  7 , 3
SelfishReporter: , S_LR_241 , 145 , -0.41793 , 20 ,  9 , 11
SelfishReporter: , S_LR_242 , 146 , -0.360906 , 9 ,  3 , 6
SelfishReporter: , S_LR_243 , 147 , -0.311526 , 2 ,  0 , 2
SelfishReporter: , S_LR_244 , 148 , -0.412481 , 38 ,  24 , 14
SelfishReporter: , S_LR_246 , 149 , -0.30946 , 13 ,  9 , 4
SelfishReporter: , S_LR_248 , 150 , -0.308108 , 3 ,  1 , 2
SelfishReporter: , S_LR_250 , 151 , -0.319902 , 10 ,  6 , 4
SelfishReporter: , S_LR_252 , 152 , -0.354827 , 21 ,  13 , 8
SelfishReporter: , S_LR_253 , 153 , -0.297274 , 1 ,  0 , 1
SelfishReporter: , S_LR_254 , 154 , -0.344079 , 24 ,  16 , 8
SelfishReporter: , S_LR_255 , 155 , -0.312255 , 7 ,  4 , 3
SelfishReporter: , S_LR_256 , 156 , 0.233772 , 17 ,  14 , 3
SelfishReporter: , S_LR_257 , 157 , -0.387092 , 28 ,  17 , 11
SelfishReporter: , S_LR_259 , 158 , -0.373597 , 16 ,  8 , 8
SelfishReporter: , S_LR_261 , 159 , -0.28726 , 4 ,  3 , 1
SelfishReporter: , S_LR_262 , 160 , -0.286966 , 20 ,  16 , 4
SelfishReporter: , S_LR_263 , 161 , -0.284091 , 5 ,  4 , 1
SelfishReporter: , S_LR_265 , 162 , -0.355976 , 21 ,  13 , 8
SelfishReporter: , S_LR_266 , 163 , -0.327557 , 13 ,  8 , 5
SelfishReporter: , S_LR_268 , 164 , -0.313985 , 12 ,  8 , 4
SelfishReporter: , S_LR_269 , 165 , -0.393064 , 32 ,  20 , 12
SelfishReporter: , S_UL_431 , 166 , -0.365283 , 13 ,  6 , 7
SelfishReporter: , S_UL_432 , 167 , -0.301373 , 5 ,  3 , 2
SelfishReporter: , S_UL_433 , 168 , -0.39408 , 21 ,  11 , 10
SelfishReporter: , S_UL_434 , 169 , -0.308084 , 3 ,  1 , 2
SelfishReporter: , S_UL_435 , 170 , -0.291291 , 24 ,  19 , 5
SelfishReporter: , S_UL_436 , 171 , -0.432275 , 32 ,  18 , 14
SelfishReporter: , S_UL_437 , 172 , -0.349229 , 7 ,  2 , 5
SelfishReporter: , S_UL_438 , 173 , -0.358323 , 15 ,  8 , 7
SelfishReporter: , S_UL_439 , 174 , -0.478683 , 36 ,  19 , 17
SelfishReporter: , S_UL_440 , 175 , -0.32415 , 14 ,  9 , 5
SelfishReporter: , S_UL_441 , 176 , -0.315796 , 6 ,  3 , 3
SelfishReporter: , S_UL_442 , 177 , -0.347677 , 23 ,  15 , 8
SelfishReporter: , S_UL_443 , 178 , -0.380459 , 25 ,  15 , 10
SelfishReporter: , S_UL_444 , 179 , -0.386526 , 23 ,  13 , 10
SelfishReporter: , S_UL_445 , 180 , -0.330498 , 7 ,  3 , 4
SelfishReporter: , S_UL_446 , 181 , -0.499967 , 41 ,  22 , 19
SelfishReporter: , S_UL_448 , 182 , -0.519211 , 47 ,  26 , 21
SelfishReporter: , S_UL_451 , 183 , -0.386723 , 23 ,  13 , 10
SelfishReporter: , S_UL_452 , 184 , -0.308922 , 8 ,  5 , 3
SelfishReporter: , S_UL_453 , 185 , -0.430111 , 33 ,  19 , 14
SelfishReporter: , S_UL_454 , 186 , -0.388118 , 23 ,  13 , 10
SelfishReporter: , S_UL_455 , 187 , -0.326927 , 8 ,  4 , 4
SelfishReporter: , S_UL_458 , 188 , 0.229224 , 1 ,  1 , 0
SelfishReporter: , S_UL_459 , 189 , -0.341128 , 4 ,  0 , 4
SelfishReporter: , S_UL_460 , 190 , -0.581945 , 52 ,  27 , 25
SelfishReporter: , S_UL_461 , 191 , -0.491963 , 43 ,  24 , 19
SelfishReporter: , S_UL_462 , 192 , -0.353644 , 11 ,  5 , 6
SelfishReporter: , S_UL_463 , 193 , -0.365316 , 29 ,  19 , 10
SelfishReporter: , S_UL_464 , 194 , -0.381298 , 14 ,  6 , 8
SelfishReporter: , S_UL_466 , 195 , -0.541791 , 31 ,  12 , 19
SelfishReporter: , S_UL_467 , 196 , -0.308107 , 3 ,  1 , 2
SelfishReporter: , S_UL_468 , 197 , -0.312318 , 7 ,  4 , 3
SelfishReporter: , S_UL_469 , 198 , -0.290615 , 3 ,  2 , 1
SelfishReporter: , S_UR_630 , 199 , -0.324016 , 14 ,  9 , 5
SelfishReporter: , S_UR_631 , 200 , -0.423517 , 29 ,  16 , 13
SelfishReporter: , S_UR_632 , 201 , -0.308194 , 3 ,  1 , 2
SelfishReporter: , S_UR_634 , 202 , -0.308143 , 3 ,  1 , 2
SelfishReporter: , S_UR_636 , 203 , -0.338341 , 10 ,  5 , 5
SelfishReporter: , S_UR_637 , 204 , -0.328222 , 18 ,  12 , 6
SelfishReporter: , S_UR_640 , 205 , -0.319933 , 10 ,  6 , 4
SelfishReporter: , S_UR_641 , 206 , -0.290617 , 3 ,  2 , 1
SelfishReporter: , S_UR_642 , 207 , -0.290599 , 3 ,  2 , 1
SelfishReporter: , S_UR_643 , 208 , -0.293964 , 2 ,  1 , 1
SelfishReporter: , S_UR_645 , 209 , -0.337562 , 5 ,  1 , 4
SelfishReporter: , S_UR_646 , 210 , -0.463227 , 35 ,  19 , 16
SelfishReporter: , S_UR_648 , 211 , -0.342708 , 14 ,  8 , 6
SelfishReporter: , S_UR_650 , 212 , -0.311544 , 2 ,  0 , 2
SelfishReporter: , S_UR_652 , 213 , 0.229128 , 1 ,  1 , 0
SelfishReporter: , S_UR_653 , 214 , 0.226729 , 6 ,  5 , 1
SelfishReporter: , S_UR_654 , 215 , -0.302662 , 15 ,  11 , 4
SelfishReporter: , S_UR_655 , 216 , -0.334672 , 11 ,  6 , 5
SelfishReporter: , S_UR_657 , 217 , -0.37373 , 16 ,  8 , 8
SelfishReporter: , S_UR_659 , 218 , -0.319286 , 5 ,  2 , 3
SelfishReporter: , S_UR_662 , 219 , -0.287392 , 4 ,  3 , 1
SelfishReporter: , S_UR_663 , 220 , -0.308115 , 3 ,  1 , 2
SelfishReporter: , S_UR_669 , 221 , -0.361692 , 14 ,  7 , 7
