ScoreForMaliciousReporter: , 1, M_LL_0 , -36.8 , 41 , 4 , 37
ScoreForMaliciousReporter: , 2, M_LL_1 , -51.3329 , 52 , 0 , 52
ScoreForMaliciousReporter: , 3, M_LL_2 , -53.0862 , 55 , 1 , 54
ScoreForMaliciousReporter: , 4, M_LL_3 , -53.593 , 58 , 3 , 55
ScoreForMaliciousReporter: , 5, M_LL_4 , -53.3902 , 55 , 1 , 54
ScoreForMaliciousReporter: , 6, M_LL_5 , -54.9635 , 58 , 2 , 56
ScoreForMaliciousReporter: , 7, M_LL_6 , -38.5387 , 44 , 4 , 40
ScoreForMaliciousReporter: , 8, M_LL_7 , -22.076 , 22 , 0 , 22
ScoreForMaliciousReporter: , 9, M_LL_8 , -64.5277 , 69 , 5 , 64
ScoreForMaliciousReporter: , 10, M_LL_9 , -56.3928 , 58 , 1 , 57
ScoreForMaliciousReporter: , 11, M_LL_10 , -19.5388 , 21 , 1 , 20
ScoreForMaliciousReporter: , 12, M_LL_11 , -33.226 , 36 , 2 , 34
ScoreForMaliciousReporter: , 13, M_LL_12 , -50.9576 , 54 , 2 , 52
ScoreForMaliciousReporter: , 14, M_LL_13 , -40.513 , 46 , 4 , 42
ScoreForMaliciousReporter: , 15, M_LL_14 , -41.3692 , 45 , 3 , 42
ScoreForMaliciousReporter: , 16, M_LL_15 , -21.4758 , 23 , 1 , 22
ScoreForMaliciousReporter: , 17, M_LL_16 , -30.1478 , 33 , 2 , 31
ScoreForMaliciousReporter: , 18, M_LL_17 , -50.7435 , 52 , 2 , 50
ScoreForMaliciousReporter: , 19, M_LL_18 , -53.6954 , 58 , 3 , 55
ScoreForMaliciousReporter: , 20, M_LL_19 , -37.0273 , 40 , 2 , 38
ScoreForMaliciousReporter: , 21, M_LL_20 , -50.8707 , 54 , 2 , 52
ScoreForMaliciousReporter: , 22, M_LL_21 , -41.4971 , 47 , 4 , 43
ScoreForMaliciousReporter: , 23, M_LL_22 , -40.7523 , 45 , 3 , 42
ScoreForMaliciousReporter: , 24, M_LL_23 , -29.391 , 31 , 1 , 30
ScoreForMaliciousReporter: , 25, M_LL_24 , -40.0014 , 43 , 2 , 41
ScoreForMaliciousReporter: , 26, M_LL_25 , -36.7628 , 42 , 4 , 38
ScoreForMaliciousReporter: , 27, M_LL_26 , -30.1782 , 30 , 0 , 30
ScoreForMaliciousReporter: , 28, M_LL_27 , -60.5023 , 65 , 3 , 62
ScoreForMaliciousReporter: , 29, M_LL_28 , -21.7246 , 22 , 0 , 22
ScoreForMaliciousReporter: , 30, M_LL_29 , -52.4114 , 56 , 3 , 53
ScoreForMaliciousReporter: , 31, M_LR_200 , -2.96142 , 3 , 0 , 3
ScoreForMaliciousReporter: , 32, M_LR_201 , -9.63683 , 11 , 1 , 10
ScoreForMaliciousReporter: , 33, M_LR_202 , -31.5804 , 32 , 0 , 32
ScoreForMaliciousReporter: , 34, M_LR_203 , 0 , 0 , 0 , 0
ScoreForMaliciousReporter: , 35, M_LR_204 , -3.71638 , 5 , 1 , 4
ScoreForMaliciousReporter: , 36, M_LR_205 , -9.87214 , 10 , 0 , 10
ScoreForMaliciousReporter: , 37, M_LR_206 , -3.70798 , 5 , 1 , 4
ScoreForMaliciousReporter: , 38, M_LR_207 , -12.8321 , 13 , 0 , 13
ScoreForMaliciousReporter: , 39, M_LR_208 , -8.40542 , 11 , 2 , 9
ScoreForMaliciousReporter: , 40, M_LR_209 , 0 , 0 , 0 , 0
ScoreForMaliciousReporter: , 41, M_LR_210 , -4.93635 , 5 , 0 , 5
ScoreForMaliciousReporter: , 42, M_LR_211 , 0 , 0 , 0 , 0
ScoreForMaliciousReporter: , 43, M_LR_212 , -0.989118 , 1 , 0 , 1
ScoreForMaliciousReporter: , 44, M_LR_213 , 0 , 0 , 0 , 0
ScoreForMaliciousReporter: , 45, M_LR_214 , -0.987933 , 1 , 0 , 1
ScoreForMaliciousReporter: , 46, M_LR_215 , -0.987933 , 1 , 0 , 1
ScoreForMaliciousReporter: , 47, M_LR_216 , -40.4689 , 41 , 0 , 41
ScoreForMaliciousReporter: , 48, M_LR_217 , -24.9527 , 29 , 3 , 26
ScoreForMaliciousReporter: , 49, M_LR_218 , -0.987933 , 1 , 0 , 1
ScoreForMaliciousReporter: , 50, M_LR_219 , -9.86236 , 10 , 0 , 10
ScoreForMaliciousReporter: , 51, M_LR_220 , -33.3156 , 35 , 1 , 34
ScoreForMaliciousReporter: , 52, M_LR_221 , 0 , 0 , 0 , 0
ScoreForMaliciousReporter: , 53, M_LR_222 , -32.1678 , 35 , 2 , 33
ScoreForMaliciousReporter: , 54, M_LR_223 , -19.7456 , 20 , 0 , 20
ScoreForMaliciousReporter: , 55, M_LR_224 , -1.97353 , 2 , 0 , 2
ScoreForMaliciousReporter: , 56, M_LR_225 , 0 , 0 , 0 , 0
ScoreForMaliciousReporter: , 57, M_LR_226 , -29.4178 , 36 , 5 , 31
ScoreForMaliciousReporter: , 58, M_LR_227 , -5.92492 , 6 , 0 , 6
ScoreForMaliciousReporter: , 59, M_LR_228 , -1.97353 , 2 , 0 , 2
ScoreForMaliciousReporter: , 60, M_LR_229 , -36.2817 , 38 , 1 , 37
ScoreForMaliciousReporter: , 61, M_UL_400 , -8.88417 , 9 , 0 , 9
ScoreForMaliciousReporter: , 62, M_UL_401 , -30.3737 , 32 , 1 , 31
ScoreForMaliciousReporter: , 63, M_UL_402 , 0 , 0 , 0 , 0
ScoreForMaliciousReporter: , 64, M_UL_403 , -10.8601 , 11 , 0 , 11
ScoreForMaliciousReporter: , 65, M_UL_404 , -16.7809 , 17 , 0 , 17
ScoreForMaliciousReporter: , 66, M_UL_405 , -8.64752 , 10 , 1 , 9
ScoreForMaliciousReporter: , 67, M_UL_406 , -18.2887 , 21 , 2 , 19
ScoreForMaliciousReporter: , 68, M_UL_407 , 0 , 0 , 0 , 0
ScoreForMaliciousReporter: , 69, M_UL_408 , -5.92473 , 6 , 0 , 6
ScoreForMaliciousReporter: , 70, M_UL_409 , 0 , 0 , 0 , 0
ScoreForMaliciousReporter: , 71, M_UL_410 , -16.7867 , 17 , 0 , 17
ScoreForMaliciousReporter: , 72, M_UL_411 , -6.90963 , 7 , 0 , 7
ScoreForMaliciousReporter: , 73, M_UL_412 , -2.96119 , 3 , 0 , 3
ScoreForMaliciousReporter: , 74, M_UL_413 , -11.6115 , 13 , 1 , 12
ScoreForMaliciousReporter: , 75, M_UL_414 , 0 , 0 , 0 , 0
ScoreForMaliciousReporter: , 76, M_UL_415 , -0.985547 , 1 , 0 , 1
ScoreForMaliciousReporter: , 77, M_UL_416 , 0 , 0 , 0 , 0
ScoreForMaliciousReporter: , 78, M_UL_417 , 0 , 0 , 0 , 0
ScoreForMaliciousReporter: , 79, M_UL_418 , -0.988013 , 1 , 0 , 1
ScoreForMaliciousReporter: , 80, M_UL_419 , 0 , 0 , 0 , 0
ScoreForMaliciousReporter: , 81, M_UL_420 , 0 , 0 , 0 , 0
ScoreForMaliciousReporter: , 82, M_UL_421 , -2.95984 , 3 , 0 , 3
ScoreForMaliciousReporter: , 83, M_UL_422 , -17.2971 , 20 , 2 , 18
ScoreForMaliciousReporter: , 84, M_UL_423 , 0 , 0 , 0 , 0
ScoreForMaliciousReporter: , 85, M_UL_424 , -7.89616 , 8 , 0 , 8
ScoreForMaliciousReporter: , 86, M_UL_425 , 0 , 0 , 0 , 0
ScoreForMaliciousReporter: , 87, M_UL_426 , -16.5482 , 18 , 1 , 17
ScoreForMaliciousReporter: , 88, M_UL_427 , -1.97111 , 2 , 0 , 2
ScoreForMaliciousReporter: , 89, M_UL_428 , -36.0935 , 44 , 6 , 38
ScoreForMaliciousReporter: , 90, M_UL_429 , -8.88032 , 9 , 0 , 9
ScoreForMaliciousReporter: , 91, M_UR_600 , -0.989164 , 1 , 0 , 1
ScoreForMaliciousReporter: , 92, M_UR_601 , 0 , 0 , 0 , 0
ScoreForMaliciousReporter: , 93, M_UR_602 , -9.63477 , 11 , 1 , 10
ScoreForMaliciousReporter: , 94, M_UR_603 , 0 , 0 , 0 , 0
ScoreForMaliciousReporter: , 95, M_UR_604 , -15.79 , 16 , 0 , 16
ScoreForMaliciousReporter: , 96, M_UR_605 , -1.74103 , 3 , 1 , 2
ScoreForMaliciousReporter: , 97, M_UR_606 , -0.989164 , 1 , 0 , 1
ScoreForMaliciousReporter: , 98, M_UR_607 , -12.8298 , 13 , 0 , 13
ScoreForMaliciousReporter: , 99, M_UR_608 , 0 , 0 , 0 , 0
ScoreForMaliciousReporter: , 100, M_UR_609 , -10.8589 , 11 , 0 , 11
ScoreForMaliciousReporter: , 101, M_UR_610 , 0 , 0 , 0 , 0
ScoreForMaliciousReporter: , 102, M_UR_611 , -14.5697 , 16 , 1 , 15
ScoreForMaliciousReporter: , 103, M_UR_612 , -9.86976 , 10 , 0 , 10
ScoreForMaliciousReporter: , 104, M_UR_613 , 0 , 0 , 0 , 0
ScoreForMaliciousReporter: , 105, M_UR_614 , -2.96256 , 3 , 0 , 3
ScoreForMaliciousReporter: , 106, M_UR_615 , 0 , 0 , 0 , 0
ScoreForMaliciousReporter: , 107, M_UR_616 , -3.94828 , 4 , 0 , 4
ScoreForMaliciousReporter: , 108, M_UR_617 , 0 , 0 , 0 , 0
ScoreForMaliciousReporter: , 109, M_UR_618 , -1.97828 , 2 , 0 , 2
ScoreForMaliciousReporter: , 110, M_UR_619 , -13.5807 , 15 , 1 , 14
ScoreForMaliciousReporter: , 111, M_UR_620 , 0 , 0 , 0 , 0
ScoreForMaliciousReporter: , 112, M_UR_621 , -2.96027 , 3 , 0 , 3
ScoreForMaliciousReporter: , 113, M_UR_622 , -0.989164 , 1 , 0 , 1
ScoreForMaliciousReporter: , 114, M_UR_623 , -0.989164 , 1 , 0 , 1
ScoreForMaliciousReporter: , 115, M_UR_624 , -15.5594 , 17 , 1 , 16
ScoreForMaliciousReporter: , 116, M_UR_625 , -2.96027 , 3 , 0 , 3
ScoreForMaliciousReporter: , 117, M_UR_626 , 0 , 0 , 0 , 0
ScoreForMaliciousReporter: , 118, M_UR_627 , 0 , 0 , 0 , 0
ScoreForMaliciousReporter: , 119, M_UR_628 , -1.97476 , 2 , 0 , 2
ScoreForMaliciousReporter: , 120, M_UR_629 , -21.7184 , 22 , 0 , 22
ScoreForSelfishReporter: , 121 , S_LL_30 , -18.8181 , 52 , 28 , 24
ScoreForSelfishReporter: , 122 , S_LL_31 , -14.5891 , 52 , 31 , 21
ScoreForSelfishReporter: , 123 , S_LL_32 , -17.0423 , 44 , 27 , 17
ScoreForSelfishReporter: , 124 , S_LL_33 , -1.12569 , 23 , 18 , 5
ScoreForSelfishReporter: , 125 , S_LL_34 , -17.7582 , 65 , 39 , 26
ScoreForSelfishReporter: , 126 , S_LL_35 , -20.8566 , 52 , 25 , 27
ScoreForSelfishReporter: , 127 , S_LL_36 , -21.1651 , 52 , 26 , 26
ScoreForSelfishReporter: , 128 , S_LL_37 , -14.7325 , 39 , 20 , 19
ScoreForSelfishReporter: , 129 , S_LL_38 , -29.8732 , 68 , 31 , 37
ScoreForSelfishReporter: , 130 , S_LL_39 , -9.57104 , 51 , 34 , 17
ScoreForSelfishReporter: , 131 , S_LL_40 , -9.67889 , 16 , 5 , 11
ScoreForSelfishReporter: , 132 , S_LL_41 , -19.2192 , 56 , 32 , 24
ScoreForSelfishReporter: , 133 , S_LL_42 , -11.8663 , 33 , 17 , 16
ScoreForSelfishReporter: , 134 , S_LL_43 , -43.9781 , 71 , 43 , 28
ScoreForSelfishReporter: , 135 , S_LL_44 , -14.2969 , 38 , 19 , 19
ScoreForSelfishReporter: , 136 , S_LL_45 , -21.6193 , 45 , 19 , 26
ScoreForSelfishReporter: , 137 , S_LL_46 , -2.24612 , 12 , 8 , 4
ScoreForSelfishReporter: , 138 , S_LL_47 , -21.5673 , 62 , 33 , 29
ScoreForSelfishReporter: , 139 , S_LL_48 , -20.5451 , 78 , 48 , 30
ScoreForSelfishReporter: , 140 , S_LL_49 , -21.2666 , 70 , 40 , 30
ScoreForSelfishReporter: , 141 , S_LL_50 , -2.49709 , 5 , 2 , 3
ScoreForSelfishReporter: , 142 , S_LL_51 , -17.4937 , 53 , 29 , 24
ScoreForSelfishReporter: , 143 , S_LL_52 , -14.251 , 47 , 27 , 20
ScoreForSelfishReporter: , 144 , S_LL_53 , -14.1371 , 49 , 28 , 21
ScoreForSelfishReporter: , 145 , S_LL_54 , -6.82483 , 24 , 14 , 10
ScoreForSelfishReporter: , 146 , S_LL_55 , -18.5042 , 62 , 39 , 23
ScoreForSelfishReporter: , 147 , S_LL_56 , -21.707 , 61 , 32 , 29
ScoreForSelfishReporter: , 148 , S_LL_57 , -15.1968 , 45 , 24 , 21
ScoreForSelfishReporter: , 149 , S_LL_58 , -15.752 , 37 , 17 , 20
ScoreForSelfishReporter: , 150 , S_LL_59 , -14.4045 , 48 , 28 , 20
ScoreForSelfishReporter: , 151 , S_LL_60 , -25.0366 , 63 , 31 , 32
ScoreForSelfishReporter: , 152 , S_LL_61 , -1.65463 , 9 , 6 , 3
ScoreForSelfishReporter: , 153 , S_LL_62 , -15.0168 , 41 , 21 , 20
ScoreForSelfishReporter: , 154 , S_LL_63 , -19.9239 , 67 , 39 , 28
ScoreForSelfishReporter: , 155 , S_LL_64 , -14.775 , 56 , 35 , 21
ScoreForSelfishReporter: , 156 , S_LL_65 , -19.4816 , 56 , 30 , 26
ScoreForSelfishReporter: , 157 , S_LL_66 , -8.79015 , 48 , 32 , 16
ScoreForSelfishReporter: , 158 , S_LL_67 , -17.5429 , 50 , 27 , 23
ScoreForSelfishReporter: , 159 , S_LL_68 , -8.48811 , 27 , 15 , 12
ScoreForSelfishReporter: , 160 , S_LL_69 , -17.2776 , 48 , 26 , 22
ScoreForSelfishReporter: , 161 , S_LR_230 , -10.3295 , 35 , 20 , 15
ScoreForSelfishReporter: , 162 , S_LR_231 , -4.79891 , 16 , 9 , 7
ScoreForSelfishReporter: , 163 , S_LR_232 , 0 , 0 , 0 , 0
ScoreForSelfishReporter: , 164 , S_LR_233 , -1.2733 , 5 , 3 , 2
ScoreForSelfishReporter: , 165 , S_LR_234 , -2.81763 , 14 , 9 , 5
ScoreForSelfishReporter: , 166 , S_LR_235 , -1.31889 , 10 , 7 , 3
ScoreForSelfishReporter: , 167 , S_LR_236 , 0.188874 , 6 , 5 , 1
ScoreForSelfishReporter: , 168 , S_LR_237 , -6.09753 , 26 , 16 , 10
ScoreForSelfishReporter: , 169 , S_LR_238 , -2.05997 , 12 , 8 , 4
ScoreForSelfishReporter: , 170 , S_LR_239 , -0.333298 , 9 , 7 , 2
ScoreForSelfishReporter: , 171 , S_LR_240 , -1.31172 , 10 , 7 , 3
ScoreForSelfishReporter: , 172 , S_LR_241 , -8.73353 , 20 , 9 , 11
ScoreForSelfishReporter: , 173 , S_LR_242 , -5.21739 , 9 , 3 , 6
ScoreForSelfishReporter: , 174 , S_LR_243 , -1.97353 , 2 , 0 , 2
ScoreForSelfishReporter: , 175 , S_LR_244 , -8.40491 , 38 , 24 , 14
ScoreForSelfishReporter: , 176 , S_LR_245 , 0 , 0 , 0 , 0
ScoreForSelfishReporter: , 177 , S_LR_246 , -1.8323 , 13 , 9 , 4
ScoreForSelfishReporter: , 178 , S_LR_247 , 0 , 0 , 0 , 0
ScoreForSelfishReporter: , 179 , S_LR_248 , -1.73954 , 3 , 1 , 2
ScoreForSelfishReporter: , 180 , S_LR_249 , 0 , 0 , 0 , 0
ScoreForSelfishReporter: , 181 , S_LR_250 , -2.54121 , 10 , 6 , 4
ScoreForSelfishReporter: , 182 , S_LR_251 , 0 , 0 , 0 , 0
ScoreForSelfishReporter: , 183 , S_LR_252 , -4.83007 , 21 , 13 , 8
ScoreForSelfishReporter: , 184 , S_LR_253 , -0.987933 , 1 , 0 , 1
ScoreForSelfishReporter: , 185 , S_LR_254 , -4.13786 , 24 , 16 , 8
ScoreForSelfishReporter: , 186 , S_LR_255 , -2.02331 , 7 , 4 , 3
ScoreForSelfishReporter: , 187 , S_LR_256 , 0.327573 , 17 , 14 , 3
ScoreForSelfishReporter: , 188 , S_LR_257 , -6.85546 , 28 , 17 , 11
ScoreForSelfishReporter: , 189 , S_LR_258 , 0 , 0 , 0 , 0
ScoreForSelfishReporter: , 190 , S_LR_259 , -6.01702 , 16 , 8 , 8
ScoreForSelfishReporter: , 191 , S_LR_260 , 0 , 0 , 0 , 0
ScoreForSelfishReporter: , 192 , S_LR_261 , -0.279088 , 4 , 3 , 1
ScoreForSelfishReporter: , 193 , S_LR_262 , -0.258043 , 20 , 16 , 4
ScoreForSelfishReporter: , 194 , S_LR_263 , -0.0517453 , 5 , 4 , 1
ScoreForSelfishReporter: , 195 , S_LR_264 , 0 , 0 , 0 , 0
ScoreForSelfishReporter: , 196 , S_LR_265 , -4.90353 , 21 , 13 , 8
ScoreForSelfishReporter: , 197 , S_LR_266 , -3.05315 , 13 , 8 , 5
ScoreForSelfishReporter: , 198 , S_LR_267 , 0 , 0 , 0 , 0
ScoreForSelfishReporter: , 199 , S_LR_268 , -2.14102 , 12 , 8 , 4
ScoreForSelfishReporter: , 200 , S_LR_269 , -7.22294 , 32 , 20 , 12
ScoreForSelfishReporter: , 201 , S_UL_430 , 0 , 0 , 0 , 0
ScoreForSelfishReporter: , 202 , S_UL_431 , -5.49448 , 13 , 6 , 7
ScoreForSelfishReporter: , 203 , S_UL_432 , -1.27412 , 5 , 3 , 2
ScoreForSelfishReporter: , 204 , S_UL_433 , -7.28527 , 21 , 11 , 10
ScoreForSelfishReporter: , 205 , S_UL_434 , -1.73787 , 3 , 1 , 2
ScoreForSelfishReporter: , 206 , S_UL_435 , -0.566156 , 24 , 19 , 5
ScoreForSelfishReporter: , 207 , S_UL_436 , -9.59295 , 32 , 18 , 14
ScoreForSelfishReporter: , 208 , S_UL_437 , -4.4708 , 7 , 2 , 5
ScoreForSelfishReporter: , 209 , S_UL_438 , -5.05315 , 15 , 8 , 7
ScoreForSelfishReporter: , 210 , S_UL_439 , -12.3345 , 36 , 19 , 17
ScoreForSelfishReporter: , 211 , S_UL_440 , -2.82611 , 14 , 9 , 5
ScoreForSelfishReporter: , 212 , S_UL_441 , -2.26394 , 6 , 3 , 3
ScoreForSelfishReporter: , 213 , S_UL_442 , -4.37071 , 23 , 15 , 8
ScoreForSelfishReporter: , 214 , S_UL_443 , -6.4448 , 25 , 15 , 10
ScoreForSelfishReporter: , 215 , S_UL_444 , -6.82048 , 23 , 13 , 10
ScoreForSelfishReporter: , 216 , S_UL_445 , -3.24819 , 7 , 3 , 4
ScoreForSelfishReporter: , 217 , S_UL_446 , -13.5817 , 41 , 22 , 19
ScoreForSelfishReporter: , 218 , S_UL_447 , 0 , 0 , 0 , 0
ScoreForSelfishReporter: , 219 , S_UL_448 , -14.7093 , 47 , 26 , 21
ScoreForSelfishReporter: , 220 , S_UL_449 , 0 , 0 , 0 , 0
ScoreForSelfishReporter: , 221 , S_UL_450 , 0 , 0 , 0 , 0
ScoreForSelfishReporter: , 222 , S_UL_451 , -6.83268 , 23 , 13 , 10
ScoreForSelfishReporter: , 223 , S_UL_452 , -1.79541 , 8 , 5 , 3
ScoreForSelfishReporter: , 224 , S_UL_453 , -9.46378 , 33 , 19 , 14
ScoreForSelfishReporter: , 225 , S_UL_454 , -6.9187 , 23 , 13 , 10
ScoreForSelfishReporter: , 226 , S_UL_455 , -3.01125 , 8 , 4 , 4
ScoreForSelfishReporter: , 227 , S_UL_456 , 0 , 0 , 0 , 0
ScoreForSelfishReporter: , 228 , S_UL_457 , 0 , 0 , 0 , 0
ScoreForSelfishReporter: , 229 , S_UL_458 , 0.234767 , 1 , 1 , 0
ScoreForSelfishReporter: , 230 , S_UL_459 , -3.94603 , 4 , 0 , 4
ScoreForSelfishReporter: , 231 , S_UL_460 , -18.4263 , 52 , 27 , 25
ScoreForSelfishReporter: , 232 , S_UL_461 , -13.113 , 43 , 24 , 19
ScoreForSelfishReporter: , 233 , S_UL_462 , -4.75435 , 11 , 5 , 6
ScoreForSelfishReporter: , 234 , S_UL_463 , -5.4966 , 29 , 19 , 10
ScoreForSelfishReporter: , 235 , S_UL_464 , -6.49686 , 14 , 6 , 8
ScoreForSelfishReporter: , 236 , S_UL_465 , 0 , 0 , 0 , 0
ScoreForSelfishReporter: , 237 , S_UL_466 , -16.0369 , 31 , 12 , 19
ScoreForSelfishReporter: , 238 , S_UL_467 , -1.73946 , 3 , 1 , 2
ScoreForSelfishReporter: , 239 , S_UL_468 , -2.0276 , 7 , 4 , 3
ScoreForSelfishReporter: , 240 , S_UL_469 , -0.518213 , 3 , 2 , 1
ScoreForSelfishReporter: , 241 , S_UR_630 , -2.81711 , 14 , 9 , 5
ScoreForSelfishReporter: , 242 , S_UR_631 , -9.06914 , 29 , 16 , 13
ScoreForSelfishReporter: , 243 , S_UR_632 , -1.74543 , 3 , 1 , 2
ScoreForSelfishReporter: , 244 , S_UR_633 , 0 , 0 , 0 , 0
ScoreForSelfishReporter: , 245 , S_UR_634 , -1.74196 , 3 , 1 , 2
ScoreForSelfishReporter: , 246 , S_UR_635 , 0 , 0 , 0 , 0
ScoreForSelfishReporter: , 247 , S_UR_636 , -3.76411 , 10 , 5 , 5
ScoreForSelfishReporter: , 248 , S_UR_637 , -3.09734 , 18 , 12 , 6
ScoreForSelfishReporter: , 249 , S_UR_638 , 0 , 0 , 0 , 0
ScoreForSelfishReporter: , 250 , S_UR_639 , 0 , 0 , 0 , 0
ScoreForSelfishReporter: , 251 , S_UR_640 , -2.54331 , 10 , 6 , 4
ScoreForSelfishReporter: , 252 , S_UR_641 , -0.518368 , 3 , 2 , 1
ScoreForSelfishReporter: , 253 , S_UR_642 , -0.517061 , 3 , 2 , 1
ScoreForSelfishReporter: , 254 , S_UR_643 , -0.755214 , 2 , 1 , 1
ScoreForSelfishReporter: , 255 , S_UR_644 , 0 , 0 , 0 , 0
ScoreForSelfishReporter: , 256 , S_UR_645 , -3.71315 , 5 , 1 , 4
ScoreForSelfishReporter: , 257 , S_UR_646 , -11.4262 , 35 , 19 , 16
ScoreForSelfishReporter: , 258 , S_UR_647 , 0 , 0 , 0 , 0
ScoreForSelfishReporter: , 259 , S_UR_648 , -4.0488 , 14 , 8 , 6
ScoreForSelfishReporter: , 260 , S_UR_649 , 0 , 0 , 0 , 0
ScoreForSelfishReporter: , 261 , S_UR_650 , -1.97476 , 2 , 0 , 2
ScoreForSelfishReporter: , 262 , S_UR_651 , 0 , 0 , 0 , 0
ScoreForSelfishReporter: , 263 , S_UR_652 , 0.2328 , 1 , 1 , 0
ScoreForSelfishReporter: , 264 , S_UR_653 , 0.183309 , 6 , 5 , 1
ScoreForSelfishReporter: , 265 , S_UR_654 , -1.36366 , 15 , 11 , 4
ScoreForSelfishReporter: , 266 , S_UR_655 , -3.52353 , 11 , 6 , 5
ScoreForSelfishReporter: , 267 , S_UR_656 , 0 , 0 , 0 , 0
ScoreForSelfishReporter: , 268 , S_UR_657 , -6.02536 , 16 , 8 , 8
ScoreForSelfishReporter: , 269 , S_UR_658 , 0 , 0 , 0 , 0
ScoreForSelfishReporter: , 270 , S_UR_659 , -2.49977 , 5 , 2 , 3
ScoreForSelfishReporter: , 271 , S_UR_660 , 0 , 0 , 0 , 0
ScoreForSelfishReporter: , 272 , S_UR_661 , 0 , 0 , 0 , 0
ScoreForSelfishReporter: , 273 , S_UR_662 , -0.288567 , 4 , 3 , 1
ScoreForSelfishReporter: , 274 , S_UR_663 , -1.74003 , 3 , 1 , 2
ScoreForSelfishReporter: , 275 , S_UR_664 , 0 , 0 , 0 , 0
ScoreForSelfishReporter: , 276 , S_UR_665 , 0 , 0 , 0 , 0
ScoreForSelfishReporter: , 277 , S_UR_666 , 0 , 0 , 0 , 0
ScoreForSelfishReporter: , 278 , S_UR_667 , 0 , 0 , 0 , 0
ScoreForSelfishReporter: , 279 , S_UR_668 , 0 , 0 , 0 , 0
ScoreForSelfishReporter: , 280 , S_UR_669 , -5.26727 , 14 , 7 , 7
ScoreForHonestReporter: , 281 , H_LL_70 , 8.60496 , 38 , 38 , 0
ScoreForHonestReporter: , 282 , H_LL_71 , 11.3012 , 55 , 55 , 0
ScoreForHonestReporter: , 283 , H_LL_72 , 6.47384 , 29 , 29 , 0
ScoreForHonestReporter: , 284 , H_LL_73 , 10.8726 , 51 , 51 , 0
ScoreForHonestReporter: , 285 , H_LL_74 , -2.98635 , 74 , 74 , 0
ScoreForHonestReporter: , 286 , H_LL_75 , 9.69057 , 42 , 42 , 0
ScoreForHonestReporter: , 287 , H_LL_76 , 5.63133 , 25 , 25 , 0
ScoreForHonestReporter: , 288 , H_LL_77 , 12.0275 , 58 , 58 , 0
ScoreForHonestReporter: , 289 , H_LL_78 , 8.39433 , 37 , 37 , 0
ScoreForHonestReporter: , 290 , H_LL_79 , -8.05574 , 75 , 75 , 0
ScoreForHonestReporter: , 291 , H_LL_80 , -3.46508 , 45 , 45 , 0
ScoreForHonestReporter: , 292 , H_LL_81 , 7.17531 , 43 , 43 , 0
ScoreForHonestReporter: , 293 , H_LL_82 , 8.24866 , 36 , 36 , 0
ScoreForHonestReporter: , 294 , H_LL_83 , 9.36327 , 63 , 63 , 0
ScoreForHonestReporter: , 295 , H_LL_84 , 8.79085 , 41 , 41 , 0
ScoreForHonestReporter: , 296 , H_LL_85 , 4.60103 , 20 , 20 , 0
ScoreForHonestReporter: , 297 , H_LL_86 , 12.9322 , 60 , 60 , 0
ScoreForHonestReporter: , 298 , H_LL_87 , 6.40491 , 28 , 28 , 0
ScoreForHonestReporter: , 299 , H_LL_88 , 12.1596 , 56 , 56 , 0
ScoreForHonestReporter: , 300 , H_LL_89 , 11.3058 , 55 , 55 , 0
ScoreForHonestReporter: , 301 , H_LL_90 , 6.05778 , 28 , 28 , 0
ScoreForHonestReporter: , 302 , H_LL_91 , 11.7504 , 56 , 56 , 0
ScoreForHonestReporter: , 303 , H_LL_92 , 7.40534 , 33 , 33 , 0
ScoreForHonestReporter: , 304 , H_LL_93 , 9.49135 , 41 , 41 , 0
ScoreForHonestReporter: , 305 , H_LL_94 , 10.099 , 57 , 57 , 0
ScoreForHonestReporter: , 306 , H_LL_95 , 11.276 , 53 , 53 , 0
ScoreForHonestReporter: , 307 , H_LL_96 , 3.22232 , 56 , 56 , 0
ScoreForHonestReporter: , 308 , H_LL_97 , 4.59007 , 70 , 70 , 0
ScoreForHonestReporter: , 309 , H_LL_98 , 6.16922 , 60 , 60 , 0
ScoreForHonestReporter: , 310 , H_LL_99 , 12.4037 , 56 , 56 , 0
ScoreForHonestReporter: , 311 , H_LL_100 , 8.60524 , 38 , 38 , 0
ScoreForHonestReporter: , 312 , H_LL_101 , 7.44605 , 33 , 33 , 0
ScoreForHonestReporter: , 313 , H_LL_102 , 4.09401 , 18 , 18 , 0
ScoreForHonestReporter: , 314 , H_LL_103 , 7.6513 , 34 , 34 , 0
ScoreForHonestReporter: , 315 , H_LL_104 , 8.69051 , 38 , 38 , 0
ScoreForHonestReporter: , 316 , H_LL_105 , 12.116 , 57 , 57 , 0
ScoreForHonestReporter: , 317 , H_LL_106 , 4.80166 , 66 , 66 , 0
ScoreForHonestReporter: , 318 , H_LL_107 , 11.3192 , 55 , 55 , 0
ScoreForHonestReporter: , 319 , H_LL_108 , 6.39749 , 29 , 29 , 0
ScoreForHonestReporter: , 320 , H_LL_109 , 10.143 , 53 , 53 , 0
ScoreForHonestReporter: , 321 , H_LL_110 , 10.0736 , 47 , 47 , 0
ScoreForHonestReporter: , 322 , H_LL_111 , 8.87688 , 38 , 38 , 0
ScoreForHonestReporter: , 323 , H_LL_112 , 10.7413 , 49 , 49 , 0
ScoreForHonestReporter: , 324 , H_LL_113 , 7.13042 , 32 , 32 , 0
ScoreForHonestReporter: , 325 , H_LL_114 , 11.1651 , 55 , 55 , 0
ScoreForHonestReporter: , 326 , H_LL_115 , 10.4776 , 47 , 47 , 0
ScoreForHonestReporter: , 327 , H_LL_116 , 8.78374 , 38 , 38 , 0
ScoreForHonestReporter: , 328 , H_LL_117 , 8.40088 , 37 , 37 , 0
ScoreForHonestReporter: , 329 , H_LL_118 , -14.6018 , 59 , 59 , 0
ScoreForHonestReporter: , 330 , H_LL_119 , 10.1237 , 44 , 44 , 0
ScoreForHonestReporter: , 331 , H_LL_120 , 10.6258 , 48 , 48 , 0
ScoreForHonestReporter: , 332 , H_LL_121 , 6.81789 , 34 , 34 , 0
ScoreForHonestReporter: , 333 , H_LL_122 , 6.13903 , 29 , 29 , 0
ScoreForHonestReporter: , 334 , H_LL_123 , 3.11359 , 14 , 14 , 0
ScoreForHonestReporter: , 335 , H_LL_124 , 10.2196 , 57 , 57 , 0
ScoreForHonestReporter: , 336 , H_LL_125 , 11.1406 , 59 , 59 , 0
ScoreForHonestReporter: , 337 , H_LL_126 , 2.31189 , 10 , 10 , 0
ScoreForHonestReporter: , 338 , H_LL_127 , 12.4335 , 58 , 58 , 0
ScoreForHonestReporter: , 339 , H_LL_128 , -8.71689 , 67 , 67 , 0
ScoreForHonestReporter: , 340 , H_LL_129 , 3.39521 , 57 , 57 , 0
ScoreForHonestReporter: , 341 , H_LL_130 , 8.23753 , 39 , 39 , 0
ScoreForHonestReporter: , 342 , H_LL_131 , 6.52938 , 30 , 30 , 0
ScoreForHonestReporter: , 343 , H_LL_132 , 10.351 , 58 , 58 , 0
ScoreForHonestReporter: , 344 , H_LL_133 , 11.9262 , 55 , 55 , 0
ScoreForHonestReporter: , 345 , H_LL_134 , 10.517 , 59 , 59 , 0
ScoreForHonestReporter: , 346 , H_LL_135 , 5.21083 , 65 , 65 , 0
ScoreForHonestReporter: , 347 , H_LL_136 , 8.28903 , 39 , 39 , 0
ScoreForHonestReporter: , 348 , H_LL_137 , 10.9806 , 48 , 48 , 0
ScoreForHonestReporter: , 349 , H_LL_138 , 5.89886 , 46 , 46 , 0
ScoreForHonestReporter: , 350 , H_LL_139 , 11.6836 , 56 , 56 , 0
ScoreForHonestReporter: , 351 , H_LL_140 , 6.63084 , 31 , 31 , 0
ScoreForHonestReporter: , 352 , H_LL_141 , 6.25109 , 27 , 27 , 0
ScoreForHonestReporter: , 353 , H_LL_142 , 4.73773 , 31 , 31 , 0
ScoreForHonestReporter: , 354 , H_LL_143 , 11.5937 , 55 , 55 , 0
ScoreForHonestReporter: , 355 , H_LL_144 , 8.60477 , 37 , 37 , 0
ScoreForHonestReporter: , 356 , H_LL_145 , 10.9736 , 59 , 59 , 0
ScoreForHonestReporter: , 357 , H_LL_146 , 10.4686 , 48 , 48 , 0
ScoreForHonestReporter: , 358 , H_LL_147 , 8.79238 , 45 , 45 , 0
ScoreForHonestReporter: , 359 , H_LL_148 , 7.16932 , 33 , 33 , 0
ScoreForHonestReporter: , 360 , H_LL_149 , 8.13229 , 38 , 38 , 0
ScoreForHonestReporter: , 361 , H_LL_150 , 12.5041 , 59 , 59 , 0
ScoreForHonestReporter: , 362 , H_LL_151 , 12.9559 , 62 , 62 , 0
ScoreForHonestReporter: , 363 , H_LL_152 , 3.52996 , 59 , 59 , 0
ScoreForHonestReporter: , 364 , H_LL_153 , 8.63803 , 38 , 38 , 0
ScoreForHonestReporter: , 365 , H_LL_154 , 4.53191 , 20 , 20 , 0
ScoreForHonestReporter: , 366 , H_LL_155 , 12.0442 , 57 , 57 , 0
ScoreForHonestReporter: , 367 , H_LL_156 , 11.5466 , 54 , 54 , 0
ScoreForHonestReporter: , 368 , H_LL_157 , 12.1772 , 55 , 55 , 0
ScoreForHonestReporter: , 369 , H_LL_158 , 8.42562 , 40 , 40 , 0
ScoreForHonestReporter: , 370 , H_LL_159 , 7.78705 , 36 , 36 , 0
ScoreForHonestReporter: , 371 , H_LL_160 , 8.99645 , 58 , 58 , 0
ScoreForHonestReporter: , 372 , H_LL_161 , 8.45447 , 37 , 37 , 0
ScoreForHonestReporter: , 373 , H_LL_162 , 8.32455 , 41 , 41 , 0
ScoreForHonestReporter: , 374 , H_LL_163 , 6.47275 , 28 , 28 , 0
ScoreForHonestReporter: , 375 , H_LL_164 , 8.95407 , 40 , 40 , 0
ScoreForHonestReporter: , 376 , H_LL_165 , 11.7241 , 52 , 52 , 0
ScoreForHonestReporter: , 377 , H_LL_166 , 5.37123 , 25 , 25 , 0
ScoreForHonestReporter: , 378 , H_LL_167 , 8.24579 , 45 , 45 , 0
ScoreForHonestReporter: , 379 , H_LL_168 , 12.2326 , 57 , 57 , 0
ScoreForHonestReporter: , 380 , H_LL_169 , 5.97476 , 58 , 58 , 0
ScoreForHonestReporter: , 381 , H_LL_170 , 9.52826 , 43 , 43 , 0
ScoreForHonestReporter: , 382 , H_LL_171 , 12.3981 , 58 , 58 , 0
ScoreForHonestReporter: , 383 , H_LL_172 , -2.16901 , 72 , 72 , 0
ScoreForHonestReporter: , 384 , H_LL_173 , 1.71809 , 45 , 45 , 0
ScoreForHonestReporter: , 385 , H_LL_174 , 11.7857 , 57 , 57 , 0
ScoreForHonestReporter: , 386 , H_LL_175 , -0.243018 , 69 , 69 , 0
ScoreForHonestReporter: , 387 , H_LL_176 , 8.00709 , 35 , 35 , 0
ScoreForHonestReporter: , 388 , H_LL_177 , 11.753 , 58 , 58 , 0
ScoreForHonestReporter: , 389 , H_LL_178 , 8.6378 , 38 , 38 , 0
ScoreForHonestReporter: , 390 , H_LL_179 , 8.99573 , 58 , 58 , 0
ScoreForHonestReporter: , 391 , H_LL_180 , 7.22842 , 35 , 35 , 0
ScoreForHonestReporter: , 392 , H_LL_181 , 6.66221 , 70 , 70 , 0
ScoreForHonestReporter: , 393 , H_LL_182 , 9.33727 , 44 , 44 , 0
ScoreForHonestReporter: , 394 , H_LL_183 , 9.83891 , 46 , 46 , 0
ScoreForHonestReporter: , 395 , H_LL_184 , 5.27177 , 24 , 24 , 0
ScoreForHonestReporter: , 396 , H_LL_185 , 8.22068 , 39 , 39 , 0
ScoreForHonestReporter: , 397 , H_LL_186 , 10 , 46 , 46 , 0
ScoreForHonestReporter: , 398 , H_LL_187 , 13.9932 , 66 , 66 , 0
ScoreForHonestReporter: , 399 , H_LL_188 , 3.68756 , 58 , 58 , 0
ScoreForHonestReporter: , 400 , H_LL_189 , 6.59606 , 68 , 68 , 0
ScoreForHonestReporter: , 401 , H_LL_190 , 10.8001 , 52 , 52 , 0
ScoreForHonestReporter: , 402 , H_LL_191 , 5.17421 , 23 , 23 , 0
ScoreForHonestReporter: , 403 , H_LL_192 , 13.9143 , 68 , 68 , 0
ScoreForHonestReporter: , 404 , H_LL_193 , 4.65666 , 21 , 21 , 0
ScoreForHonestReporter: , 405 , H_LL_194 , 2.12701 , 63 , 63 , 0
ScoreForHonestReporter: , 406 , H_LL_195 , 11.5365 , 55 , 55 , 0
ScoreForHonestReporter: , 407 , H_LL_196 , 4.00081 , 33 , 33 , 0
ScoreForHonestReporter: , 408 , H_LL_197 , 13.7155 , 65 , 65 , 0
ScoreForHonestReporter: , 409 , H_LL_198 , 11.9947 , 53 , 53 , 0
ScoreForHonestReporter: , 410 , H_LL_199 , 9.51538 , 43 , 43 , 0
ScoreForHonestReporter: , 411 , H_LR_270 , 0 , 0 , 0 , 0
ScoreForHonestReporter: , 412 , H_LR_271 , 0 , 0 , 0 , 0
ScoreForHonestReporter: , 413 , H_LR_272 , 0 , 0 , 0 , 0
ScoreForHonestReporter: , 414 , H_LR_273 , 1.64508 , 7 , 7 , 0
ScoreForHonestReporter: , 415 , H_LR_274 , 6.34677 , 27 , 27 , 0
ScoreForHonestReporter: , 416 , H_LR_275 , 0 , 0 , 0 , 0
ScoreForHonestReporter: , 417 , H_LR_276 , 0 , 0 , 0 , 0
ScoreForHonestReporter: , 418 , H_LR_277 , 0 , 0 , 0 , 0
ScoreForHonestReporter: , 419 , H_LR_278 , 0 , 0 , 0 , 0
ScoreForHonestReporter: , 420 , H_LR_279 , 0 , 0 , 0 , 0
ScoreForHonestReporter: , 421 , H_LR_280 , 7.77071 , 34 , 34 , 0
ScoreForHonestReporter: , 422 , H_LR_281 , 5.80516 , 25 , 25 , 0
ScoreForHonestReporter: , 423 , H_LR_282 , 2.58543 , 11 , 11 , 0
ScoreForHonestReporter: , 424 , H_LR_283 , 1.17399 , 5 , 5 , 0
ScoreForHonestReporter: , 425 , H_LR_284 , 0.704932 , 3 , 3 , 0
ScoreForHonestReporter: , 426 , H_LR_285 , 1.4097 , 6 , 6 , 0
ScoreForHonestReporter: , 427 , H_LR_286 , 3.05333 , 13 , 13 , 0
ScoreForHonestReporter: , 428 , H_LR_287 , 2.12058 , 9 , 9 , 0
ScoreForHonestReporter: , 429 , H_LR_288 , 1.88156 , 8 , 8 , 0
ScoreForHonestReporter: , 430 , H_LR_289 , 2.58905 , 11 , 11 , 0
ScoreForHonestReporter: , 431 , H_LR_290 , 3.53042 , 15 , 15 , 0
ScoreForHonestReporter: , 432 , H_LR_291 , 5.17342 , 22 , 22 , 0
ScoreForHonestReporter: , 433 , H_LR_292 , 1.64961 , 7 , 7 , 0
ScoreForHonestReporter: , 434 , H_LR_293 , 7.38753 , 32 , 32 , 0
ScoreForHonestReporter: , 435 , H_LR_294 , 0.940237 , 4 , 4 , 0
ScoreForHonestReporter: , 436 , H_LR_295 , 4.94153 , 21 , 21 , 0
ScoreForHonestReporter: , 437 , H_LR_296 , 0.471137 , 2 , 2 , 0
ScoreForHonestReporter: , 438 , H_LR_297 , 7.75585 , 33 , 33 , 0
ScoreForHonestReporter: , 439 , H_LR_298 , 6.68213 , 29 , 29 , 0
ScoreForHonestReporter: , 440 , H_LR_299 , 4.23329 , 18 , 18 , 0
ScoreForHonestReporter: , 441 , H_LR_300 , 1.41168 , 6 , 6 , 0
ScoreForHonestReporter: , 442 , H_LR_301 , 0 , 0 , 0 , 0
ScoreForHonestReporter: , 443 , H_LR_302 , 5.64924 , 24 , 24 , 0
ScoreForHonestReporter: , 444 , H_LR_303 , 0 , 0 , 0 , 0
ScoreForHonestReporter: , 445 , H_LR_304 , 6.11554 , 26 , 26 , 0
ScoreForHonestReporter: , 446 , H_LR_305 , 0 , 0 , 0 , 0
ScoreForHonestReporter: , 447 , H_LR_306 , 8.8376 , 38 , 38 , 0
ScoreForHonestReporter: , 448 , H_LR_307 , 0 , 0 , 0 , 0
ScoreForHonestReporter: , 449 , H_LR_308 , 1.17884 , 5 , 5 , 0
ScoreForHonestReporter: , 450 , H_LR_309 , 1.17653 , 5 , 5 , 0
ScoreForHonestReporter: , 451 , H_LR_310 , 2.11254 , 9 , 9 , 0
ScoreForHonestReporter: , 452 , H_LR_311 , 4.93669 , 21 , 21 , 0
ScoreForHonestReporter: , 453 , H_LR_312 , 3.05678 , 13 , 13 , 0
ScoreForHonestReporter: , 454 , H_LR_313 , 2.58855 , 11 , 11 , 0
ScoreForHonestReporter: , 455 , H_LR_314 , 2.58423 , 11 , 11 , 0
ScoreForHonestReporter: , 456 , H_LR_315 , 8.23223 , 35 , 35 , 0
ScoreForHonestReporter: , 457 , H_LR_316 , 0 , 0 , 0 , 0
ScoreForHonestReporter: , 458 , H_LR_317 , 3.29555 , 14 , 14 , 0
ScoreForHonestReporter: , 459 , H_LR_318 , 3.05253 , 13 , 13 , 0
ScoreForHonestReporter: , 460 , H_LR_319 , 2.59078 , 11 , 11 , 0
ScoreForHonestReporter: , 461 , H_LR_320 , 0 , 0 , 0 , 0
ScoreForHonestReporter: , 462 , H_LR_321 , 3.05547 , 13 , 13 , 0
ScoreForHonestReporter: , 463 , H_LR_322 , 8.37101 , 36 , 36 , 0
ScoreForHonestReporter: , 464 , H_LR_323 , 0 , 0 , 0 , 0
ScoreForHonestReporter: , 465 , H_LR_324 , 3.21309 , 14 , 14 , 0
ScoreForHonestReporter: , 466 , H_LR_325 , 0 , 0 , 0 , 0
ScoreForHonestReporter: , 467 , H_LR_326 , 0 , 0 , 0 , 0
ScoreForHonestReporter: , 468 , H_LR_327 , 4.70714 , 20 , 20 , 0
ScoreForHonestReporter: , 469 , H_LR_328 , 4.23455 , 18 , 18 , 0
ScoreForHonestReporter: , 470 , H_LR_329 , 5.23867 , 23 , 23 , 0
ScoreForHonestReporter: , 471 , H_LR_330 , 6.91406 , 30 , 30 , 0
ScoreForHonestReporter: , 472 , H_LR_331 , 3.05547 , 13 , 13 , 0
ScoreForHonestReporter: , 473 , H_LR_332 , 1.41277 , 6 , 6 , 0
ScoreForHonestReporter: , 474 , H_LR_333 , 2.81837 , 12 , 12 , 0
ScoreForHonestReporter: , 475 , H_LR_334 , 0 , 0 , 0 , 0
ScoreForHonestReporter: , 476 , H_LR_335 , 0.236284 , 1 , 1 , 0
ScoreForHonestReporter: , 477 , H_LR_336 , 0 , 0 , 0 , 0
ScoreForHonestReporter: , 478 , H_LR_337 , 5.10014 , 22 , 22 , 0
ScoreForHonestReporter: , 479 , H_LR_338 , 0 , 0 , 0 , 0
ScoreForHonestReporter: , 480 , H_LR_339 , 0.469107 , 2 , 2 , 0
ScoreForHonestReporter: , 481 , H_LR_340 , 8.68477 , 38 , 38 , 0
ScoreForHonestReporter: , 482 , H_LR_341 , 0.235305 , 1 , 1 , 0
ScoreForHonestReporter: , 483 , H_LR_342 , 0 , 0 , 0 , 0
ScoreForHonestReporter: , 484 , H_LR_343 , 1.40975 , 6 , 6 , 0
ScoreForHonestReporter: , 485 , H_LR_344 , 0.236284 , 1 , 1 , 0
ScoreForHonestReporter: , 486 , H_LR_345 , 0 , 0 , 0 , 0
ScoreForHonestReporter: , 487 , H_LR_346 , 1.88115 , 8 , 8 , 0
ScoreForHonestReporter: , 488 , H_LR_347 , 0 , 0 , 0 , 0
ScoreForHonestReporter: , 489 , H_LR_348 , 2.11755 , 9 , 9 , 0
ScoreForHonestReporter: , 490 , H_LR_349 , 0 , 0 , 0 , 0
ScoreForHonestReporter: , 491 , H_LR_350 , 0.942278 , 4 , 4 , 0
ScoreForHonestReporter: , 492 , H_LR_351 , 0 , 0 , 0 , 0
ScoreForHonestReporter: , 493 , H_LR_352 , 0.469107 , 2 , 2 , 0
ScoreForHonestReporter: , 494 , H_LR_353 , 0 , 0 , 0 , 0
ScoreForHonestReporter: , 495 , H_LR_354 , 1.64334 , 7 , 7 , 0
ScoreForHonestReporter: , 496 , H_LR_355 , 2.12026 , 9 , 9 , 0
ScoreForHonestReporter: , 497 , H_LR_356 , 0 , 0 , 0 , 0
ScoreForHonestReporter: , 498 , H_LR_357 , 0.467481 , 2 , 2 , 0
ScoreForHonestReporter: , 499 , H_LR_358 , 6.58474 , 28 , 28 , 0
ScoreForHonestReporter: , 500 , H_LR_359 , 6.21068 , 27 , 27 , 0
ScoreForHonestReporter: , 501 , H_LR_360 , 5.50154 , 24 , 24 , 0
ScoreForHonestReporter: , 502 , H_LR_361 , 0 , 0 , 0 , 0
ScoreForHonestReporter: , 503 , H_LR_362 , 0 , 0 , 0 , 0
ScoreForHonestReporter: , 504 , H_LR_363 , 4.70894 , 20 , 20 , 0
ScoreForHonestReporter: , 505 , H_LR_364 , 4.47431 , 19 , 19 , 0
ScoreForHonestReporter: , 506 , H_LR_365 , 0 , 0 , 0 , 0
ScoreForHonestReporter: , 507 , H_LR_366 , 5.41308 , 23 , 23 , 0
ScoreForHonestReporter: , 508 , H_LR_367 , 6.34317 , 27 , 27 , 0
ScoreForHonestReporter: , 509 , H_LR_368 , 0 , 0 , 0 , 0
ScoreForHonestReporter: , 510 , H_LR_369 , 0 , 0 , 0 , 0
ScoreForHonestReporter: , 511 , H_LR_370 , 2.50514 , 11 , 11 , 0
ScoreForHonestReporter: , 512 , H_LR_371 , 5.64712 , 24 , 24 , 0
ScoreForHonestReporter: , 513 , H_LR_372 , 0 , 0 , 0 , 0
ScoreForHonestReporter: , 514 , H_LR_373 , 0.938447 , 4 , 4 , 0
ScoreForHonestReporter: , 515 , H_LR_374 , 0 , 0 , 0 , 0
ScoreForHonestReporter: , 516 , H_LR_375 , 1.41168 , 6 , 6 , 0
ScoreForHonestReporter: , 517 , H_LR_376 , 0 , 0 , 0 , 0
ScoreForHonestReporter: , 518 , H_LR_377 , 4.70542 , 20 , 20 , 0
ScoreForHonestReporter: , 519 , H_LR_378 , 0.940237 , 4 , 4 , 0
ScoreForHonestReporter: , 520 , H_LR_379 , 0 , 0 , 0 , 0
ScoreForHonestReporter: , 521 , H_LR_380 , 1.64847 , 7 , 7 , 0
ScoreForHonestReporter: , 522 , H_LR_381 , 1.17908 , 5 , 5 , 0
ScoreForHonestReporter: , 523 , H_LR_382 , 3.29781 , 14 , 14 , 0
ScoreForHonestReporter: , 524 , H_LR_383 , 0 , 0 , 0 , 0
ScoreForHonestReporter: , 525 , H_LR_384 , 3.76304 , 16 , 16 , 0
ScoreForHonestReporter: , 526 , H_LR_385 , 0 , 0 , 0 , 0
ScoreForHonestReporter: , 527 , H_LR_386 , 1.17653 , 5 , 5 , 0
ScoreForHonestReporter: , 528 , H_LR_387 , 0 , 0 , 0 , 0
ScoreForHonestReporter: , 529 , H_LR_388 , 0.235305 , 1 , 1 , 0
ScoreForHonestReporter: , 530 , H_LR_389 , 0 , 0 , 0 , 0
ScoreForHonestReporter: , 531 , H_LR_390 , 0 , 0 , 0 , 0
ScoreForHonestReporter: , 532 , H_LR_391 , 0.940244 , 4 , 4 , 0
ScoreForHonestReporter: , 533 , H_LR_392 , 0 , 0 , 0 , 0
ScoreForHonestReporter: , 534 , H_LR_393 , 0 , 0 , 0 , 0
ScoreForHonestReporter: , 535 , H_LR_394 , 0.704097 , 3 , 3 , 0
ScoreForHonestReporter: , 536 , H_LR_395 , 1.8854 , 8 , 8 , 0
ScoreForHonestReporter: , 537 , H_LR_396 , 0 , 0 , 0 , 0
ScoreForHonestReporter: , 538 , H_LR_397 , 1.17435 , 5 , 5 , 0
ScoreForHonestReporter: , 539 , H_LR_398 , 0 , 0 , 0 , 0
ScoreForHonestReporter: , 540 , H_LR_399 , 0.704932 , 3 , 3 , 0
ScoreForHonestReporter: , 541 , H_UL_470 , 2.10593 , 9 , 9 , 0
ScoreForHonestReporter: , 542 , H_UL_471 , 0.705529 , 3 , 3 , 0
ScoreForHonestReporter: , 543 , H_UL_472 , 6.48494 , 28 , 28 , 0
ScoreForHonestReporter: , 544 , H_UL_473 , 2.34242 , 10 , 10 , 0
ScoreForHonestReporter: , 545 , H_UL_474 , 2.57313 , 11 , 11 , 0
ScoreForHonestReporter: , 546 , H_UL_475 , 5.54051 , 24 , 24 , 0
ScoreForHonestReporter: , 547 , H_UL_476 , 2.34205 , 10 , 10 , 0
ScoreForHonestReporter: , 548 , H_UL_477 , 0 , 0 , 0 , 0
ScoreForHonestReporter: , 549 , H_UL_478 , 0 , 0 , 0 , 0
ScoreForHonestReporter: , 550 , H_UL_479 , 3.75025 , 16 , 16 , 0
ScoreForHonestReporter: , 551 , H_UL_480 , 2.1029 , 9 , 9 , 0
ScoreForHonestReporter: , 552 , H_UL_481 , 0.470323 , 2 , 2 , 0
ScoreForHonestReporter: , 553 , H_UL_482 , 6.0748 , 27 , 27 , 0
ScoreForHonestReporter: , 554 , H_UL_483 , 2.57758 , 11 , 11 , 0
ScoreForHonestReporter: , 555 , H_UL_484 , 0 , 0 , 0 , 0
ScoreForHonestReporter: , 556 , H_UL_485 , 1.16713 , 5 , 5 , 0
ScoreForHonestReporter: , 557 , H_UL_486 , 0.93811 , 4 , 4 , 0
ScoreForHonestReporter: , 558 , H_UL_487 , 0 , 0 , 0 , 0
ScoreForHonestReporter: , 559 , H_UL_488 , 0 , 0 , 0 , 0
ScoreForHonestReporter: , 560 , H_UL_489 , 0 , 0 , 0 , 0
ScoreForHonestReporter: , 561 , H_UL_490 , 0 , 0 , 0 , 0
ScoreForHonestReporter: , 562 , H_UL_491 , 2.10988 , 9 , 9 , 0
ScoreForHonestReporter: , 563 , H_UL_492 , 4.36039 , 19 , 19 , 0
ScoreForHonestReporter: , 564 , H_UL_493 , 1.40038 , 6 , 6 , 0
ScoreForHonestReporter: , 565 , H_UL_494 , 0 , 0 , 0 , 0
ScoreForHonestReporter: , 566 , H_UL_495 , 3.28389 , 14 , 14 , 0
ScoreForHonestReporter: , 567 , H_UL_496 , 9.31632 , 40 , 40 , 0
ScoreForHonestReporter: , 568 , H_UL_497 , 0 , 0 , 0 , 0
ScoreForHonestReporter: , 569 , H_UL_498 , 0 , 0 , 0 , 0
ScoreForHonestReporter: , 570 , H_UL_499 , 2.10848 , 9 , 9 , 0
ScoreForHonestReporter: , 571 , H_UL_500 , 3.74774 , 16 , 16 , 0
ScoreForHonestReporter: , 572 , H_UL_501 , 0.703049 , 3 , 3 , 0
ScoreForHonestReporter: , 573 , H_UL_502 , 0 , 0 , 0 , 0
ScoreForHonestReporter: , 574 , H_UL_503 , 0 , 0 , 0 , 0
ScoreForHonestReporter: , 575 , H_UL_504 , 6.48091 , 28 , 28 , 0
ScoreForHonestReporter: , 576 , H_UL_505 , 0.935681 , 4 , 4 , 0
ScoreForHonestReporter: , 577 , H_UL_506 , 0.235654 , 1 , 1 , 0
ScoreForHonestReporter: , 578 , H_UL_507 , 0.232632 , 1 , 1 , 0
ScoreForHonestReporter: , 579 , H_UL_508 , 0.235654 , 1 , 1 , 0
ScoreForHonestReporter: , 580 , H_UL_509 , 3.89215 , 17 , 17 , 0
ScoreForHonestReporter: , 581 , H_UL_510 , 0.703049 , 3 , 3 , 0
ScoreForHonestReporter: , 582 , H_UL_511 , 0 , 0 , 0 , 0
ScoreForHonestReporter: , 583 , H_UL_512 , 0 , 0 , 0 , 0
ScoreForHonestReporter: , 584 , H_UL_513 , 3.92085 , 17 , 17 , 0
ScoreForHonestReporter: , 585 , H_UL_514 , 5.39965 , 23 , 23 , 0
ScoreForHonestReporter: , 586 , H_UL_515 , 0 , 0 , 0 , 0
ScoreForHonestReporter: , 587 , H_UL_516 , 3.89748 , 17 , 17 , 0
ScoreForHonestReporter: , 588 , H_UL_517 , 0.235654 , 1 , 1 , 0
ScoreForHonestReporter: , 589 , H_UL_518 , 0 , 0 , 0 , 0
ScoreForHonestReporter: , 590 , H_UL_519 , 4.13218 , 18 , 18 , 0
ScoreForHonestReporter: , 591 , H_UL_520 , 0 , 0 , 0 , 0
ScoreForHonestReporter: , 592 , H_UL_521 , 1.16801 , 5 , 5 , 0
ScoreForHonestReporter: , 593 , H_UL_522 , 0 , 0 , 0 , 0
ScoreForHonestReporter: , 594 , H_UL_523 , 0.234767 , 1 , 1 , 0
ScoreForHonestReporter: , 595 , H_UL_524 , 1.8685 , 8 , 8 , 0
ScoreForHonestReporter: , 596 , H_UL_525 , 0 , 0 , 0 , 0
ScoreForHonestReporter: , 597 , H_UL_526 , 1.16801 , 5 , 5 , 0
ScoreForHonestReporter: , 598 , H_UL_527 , 0 , 0 , 0 , 0
ScoreForHonestReporter: , 599 , H_UL_528 , 4.36287 , 19 , 19 , 0
ScoreForHonestReporter: , 600 , H_UL_529 , 1.17168 , 5 , 5 , 0
ScoreForHonestReporter: , 601 , H_UL_530 , 0 , 0 , 0 , 0
ScoreForHonestReporter: , 602 , H_UL_531 , 8.13633 , 35 , 35 , 0
ScoreForHonestReporter: , 603 , H_UL_532 , 6.95595 , 30 , 30 , 0
ScoreForHonestReporter: , 604 , H_UL_533 , 3.29126 , 14 , 14 , 0
ScoreForHonestReporter: , 605 , H_UL_534 , 3.75255 , 16 , 16 , 0
ScoreForHonestReporter: , 606 , H_UL_535 , 1.40401 , 6 , 6 , 0
ScoreForHonestReporter: , 607 , H_UL_536 , 0.702955 , 3 , 3 , 0
ScoreForHonestReporter: , 608 , H_UL_537 , 8.36586 , 36 , 36 , 0
ScoreForHonestReporter: , 609 , H_UL_538 , 2.1029 , 9 , 9 , 0
ScoreForHonestReporter: , 610 , H_UL_539 , 0.234767 , 1 , 1 , 0
ScoreForHonestReporter: , 611 , H_UL_540 , 1.17611 , 5 , 5 , 0
ScoreForHonestReporter: , 612 , H_UL_541 , 2.34158 , 10 , 10 , 0
ScoreForHonestReporter: , 613 , H_UL_542 , 3.042 , 13 , 13 , 0
ScoreForHonestReporter: , 614 , H_UL_543 , 0 , 0 , 0 , 0
ScoreForHonestReporter: , 615 , H_UL_544 , 0.468282 , 2 , 2 , 0
ScoreForHonestReporter: , 616 , H_UL_545 , 5.16044 , 22 , 22 , 0
ScoreForHonestReporter: , 617 , H_UL_546 , 0 , 0 , 0 , 0
ScoreForHonestReporter: , 618 , H_UL_547 , 0.467301 , 2 , 2 , 0
ScoreForHonestReporter: , 619 , H_UL_548 , 4.90294 , 21 , 21 , 0
ScoreForHonestReporter: , 620 , H_UL_549 , 3.89955 , 17 , 17 , 0
ScoreForHonestReporter: , 621 , H_UL_550 , 1.63675 , 7 , 7 , 0
ScoreForHonestReporter: , 622 , H_UL_551 , 2.33892 , 10 , 10 , 0
ScoreForHonestReporter: , 623 , H_UL_552 , 3.04797 , 13 , 13 , 0
ScoreForHonestReporter: , 624 , H_UL_553 , 1.87383 , 8 , 8 , 0
ScoreForHonestReporter: , 625 , H_UL_554 , 5.86938 , 25 , 25 , 0
ScoreForHonestReporter: , 626 , H_UL_555 , 3.65229 , 16 , 16 , 0
ScoreForHonestReporter: , 627 , H_UL_556 , 2.57136 , 11 , 11 , 0
ScoreForHonestReporter: , 628 , H_UL_557 , 2.58102 , 11 , 11 , 0
ScoreForHonestReporter: , 629 , H_UL_558 , 0.232632 , 1 , 1 , 0
ScoreForHonestReporter: , 630 , H_UL_559 , 1.62623 , 7 , 7 , 0
ScoreForHonestReporter: , 631 , H_UL_560 , 6.38862 , 28 , 28 , 0
ScoreForHonestReporter: , 632 , H_UL_561 , 0 , 0 , 0 , 0
ScoreForHonestReporter: , 633 , H_UL_562 , 2.34158 , 10 , 10 , 0
ScoreForHonestReporter: , 634 , H_UL_563 , 2.09928 , 9 , 9 , 0
ScoreForHonestReporter: , 635 , H_UL_564 , 1.16801 , 5 , 5 , 0
ScoreForHonestReporter: , 636 , H_UL_565 , 2.81461 , 12 , 12 , 0
ScoreForHonestReporter: , 637 , H_UL_566 , 5.16579 , 22 , 22 , 0
ScoreForHonestReporter: , 638 , H_UL_567 , 1.16588 , 5 , 5 , 0
ScoreForHonestReporter: , 639 , H_UL_568 , 1.63722 , 7 , 7 , 0
ScoreForHonestReporter: , 640 , H_UL_569 , 2.96173 , 13 , 13 , 0
ScoreForHonestReporter: , 641 , H_UL_570 , 0 , 0 , 0 , 0
ScoreForHonestReporter: , 642 , H_UL_571 , 6.10385 , 26 , 26 , 0
ScoreForHonestReporter: , 643 , H_UL_572 , 0 , 0 , 0 , 0
ScoreForHonestReporter: , 644 , H_UL_573 , 0.935681 , 4 , 4 , 0
ScoreForHonestReporter: , 645 , H_UL_574 , 1.17044 , 5 , 5 , 0
ScoreForHonestReporter: , 646 , H_UL_575 , 0 , 0 , 0 , 0
ScoreForHonestReporter: , 647 , H_UL_576 , 0.703049 , 3 , 3 , 0
ScoreForHonestReporter: , 648 , H_UL_577 , 0.703049 , 3 , 3 , 0
ScoreForHonestReporter: , 649 , H_UL_578 , 2.8125 , 12 , 12 , 0
ScoreForHonestReporter: , 650 , H_UL_579 , 2.58654 , 11 , 11 , 0
ScoreForHonestReporter: , 651 , H_UL_580 , 2.10682 , 9 , 9 , 0
ScoreForHonestReporter: , 652 , H_UL_581 , 0 , 0 , 0 , 0
ScoreForHonestReporter: , 653 , H_UL_582 , 0 , 0 , 0 , 0
ScoreForHonestReporter: , 654 , H_UL_583 , 3.28664 , 14 , 14 , 0
ScoreForHonestReporter: , 655 , H_UL_584 , 0 , 0 , 0 , 0
ScoreForHonestReporter: , 656 , H_UL_585 , 2.57313 , 11 , 11 , 0
ScoreForHonestReporter: , 657 , H_UL_586 , 2.1029 , 9 , 9 , 0
ScoreForHonestReporter: , 658 , H_UL_587 , 3.15307 , 17 , 17 , 0
ScoreForHonestReporter: , 659 , H_UL_588 , 0 , 0 , 0 , 0
ScoreForHonestReporter: , 660 , H_UL_589 , 0 , 0 , 0 , 0
ScoreForHonestReporter: , 661 , H_UL_590 , 0.935681 , 4 , 4 , 0
ScoreForHonestReporter: , 662 , H_UL_591 , 0 , 0 , 0 , 0
ScoreForHonestReporter: , 663 , H_UL_592 , 6.25498 , 27 , 27 , 0
ScoreForHonestReporter: , 664 , H_UL_593 , 0.933244 , 4 , 4 , 0
ScoreForHonestReporter: , 665 , H_UL_594 , 2.31079 , 10 , 10 , 0
ScoreForHonestReporter: , 666 , H_UL_595 , 0.698477 , 3 , 3 , 0
ScoreForHonestReporter: , 667 , H_UL_596 , 0.468453 , 2 , 2 , 0
ScoreForHonestReporter: , 668 , H_UL_597 , 6.72078 , 29 , 29 , 0
ScoreForHonestReporter: , 669 , H_UL_598 , 4.69414 , 20 , 20 , 0
ScoreForHonestReporter: , 670 , H_UL_599 , 1.63784 , 7 , 7 , 0
ScoreForHonestReporter: , 671 , H_UR_670 , 0 , 0 , 0 , 0
ScoreForHonestReporter: , 672 , H_UR_671 , 0.466315 , 2 , 2 , 0
ScoreForHonestReporter: , 673 , H_UR_672 , 0.235654 , 1 , 1 , 0
ScoreForHonestReporter: , 674 , H_UR_673 , 6.00937 , 26 , 26 , 0
ScoreForHonestReporter: , 675 , H_UR_674 , 1.17331 , 5 , 5 , 0
ScoreForHonestReporter: , 676 , H_UR_675 , 0 , 0 , 0 , 0
ScoreForHonestReporter: , 677 , H_UR_676 , 1.86939 , 8 , 8 , 0
ScoreForHonestReporter: , 678 , H_UR_677 , 1.17304 , 5 , 5 , 0
ScoreForHonestReporter: , 679 , H_UR_678 , 4.45431 , 19 , 19 , 0
ScoreForHonestReporter: , 680 , H_UR_679 , 0 , 0 , 0 , 0
ScoreForHonestReporter: , 681 , H_UR_680 , 0 , 0 , 0 , 0
ScoreForHonestReporter: , 682 , H_UR_681 , 0 , 0 , 0 , 0
ScoreForHonestReporter: , 683 , H_UR_682 , 0 , 0 , 0 , 0
ScoreForHonestReporter: , 684 , H_UR_683 , 0 , 0 , 0 , 0
ScoreForHonestReporter: , 685 , H_UR_684 , 0 , 0 , 0 , 0
ScoreForHonestReporter: , 686 , H_UR_685 , 0.235654 , 1 , 1 , 0
ScoreForHonestReporter: , 687 , H_UR_686 , 3.75349 , 16 , 16 , 0
ScoreForHonestReporter: , 688 , H_UR_687 , 0 , 0 , 0 , 0
ScoreForHonestReporter: , 689 , H_UR_688 , 0 , 0 , 0 , 0
ScoreForHonestReporter: , 690 , H_UR_689 , 0 , 0 , 0 , 0
ScoreForHonestReporter: , 691 , H_UR_690 , 0 , 0 , 0 , 0
ScoreForHonestReporter: , 692 , H_UR_691 , 0 , 0 , 0 , 0
ScoreForHonestReporter: , 693 , H_UR_692 , 1.16944 , 5 , 5 , 0
ScoreForHonestReporter: , 694 , H_UR_693 , 1.17108 , 5 , 5 , 0
ScoreForHonestReporter: , 695 , H_UR_694 , 0 , 0 , 0 , 0
ScoreForHonestReporter: , 696 , H_UR_695 , 5.63951 , 24 , 24 , 0
ScoreForHonestReporter: , 697 , H_UR_696 , 3.98136 , 17 , 17 , 0
ScoreForHonestReporter: , 698 , H_UR_697 , 0.468453 , 2 , 2 , 0
ScoreForHonestReporter: , 699 , H_UR_698 , 0.2328 , 1 , 1 , 0
ScoreForHonestReporter: , 700 , H_UR_699 , 2.81806 , 12 , 12 , 0
ScoreForHonestReporter: , 701 , H_UR_700 , 5.86982 , 25 , 25 , 0
ScoreForHonestReporter: , 702 , H_UR_701 , 2.34118 , 10 , 10 , 0
ScoreForHonestReporter: , 703 , H_UR_702 , 6.57865 , 28 , 28 , 0
ScoreForHonestReporter: , 704 , H_UR_703 , 0 , 0 , 0 , 0
ScoreForHonestReporter: , 705 , H_UR_704 , 0 , 0 , 0 , 0
ScoreForHonestReporter: , 706 , H_UR_705 , 0 , 0 , 0 , 0
ScoreForHonestReporter: , 707 , H_UR_706 , 1.16992 , 5 , 5 , 0
ScoreForHonestReporter: , 708 , H_UR_707 , 0.699115 , 3 , 3 , 0
ScoreForHonestReporter: , 709 , H_UR_708 , 0.235654 , 1 , 1 , 0
ScoreForHonestReporter: , 710 , H_UR_709 , 4.4639 , 19 , 19 , 0
ScoreForHonestReporter: , 711 , H_UR_710 , 0.2328 , 1 , 1 , 0
ScoreForHonestReporter: , 712 , H_UR_711 , 0 , 0 , 0 , 0
ScoreForHonestReporter: , 713 , H_UR_712 , 0 , 0 , 0 , 0
ScoreForHonestReporter: , 714 , H_UR_713 , 3.52426 , 15 , 15 , 0
ScoreForHonestReporter: , 715 , H_UR_714 , 0 , 0 , 0 , 0
ScoreForHonestReporter: , 716 , H_UR_715 , 0.4663 , 2 , 2 , 0
ScoreForHonestReporter: , 717 , H_UR_716 , 0 , 0 , 0 , 0
ScoreForHonestReporter: , 718 , H_UR_717 , 0.2328 , 1 , 1 , 0
ScoreForHonestReporter: , 719 , H_UR_718 , 5.86938 , 25 , 25 , 0
ScoreForHonestReporter: , 720 , H_UR_719 , 0 , 0 , 0 , 0
ScoreForHonestReporter: , 721 , H_UR_720 , 0.465599 , 2 , 2 , 0
ScoreForHonestReporter: , 722 , H_UR_721 , 3.28757 , 14 , 14 , 0
ScoreForHonestReporter: , 723 , H_UR_722 , 2.57985 , 11 , 11 , 0
ScoreForHonestReporter: , 724 , H_UR_723 , 0 , 0 , 0 , 0
ScoreForHonestReporter: , 725 , H_UR_724 , 3.0558 , 13 , 13 , 0
ScoreForHonestReporter: , 726 , H_UR_725 , 4.7008 , 20 , 20 , 0
ScoreForHonestReporter: , 727 , H_UR_726 , 2.57717 , 11 , 11 , 0
ScoreForHonestReporter: , 728 , H_UR_727 , 2.11104 , 9 , 9 , 0
ScoreForHonestReporter: , 729 , H_UR_728 , 1.87269 , 8 , 8 , 0
ScoreForHonestReporter: , 730 , H_UR_729 , 1.64091 , 7 , 7 , 0
ScoreForHonestReporter: , 731 , H_UR_730 , 0 , 0 , 0 , 0
ScoreForHonestReporter: , 732 , H_UR_731 , 0 , 0 , 0 , 0
ScoreForHonestReporter: , 733 , H_UR_732 , 4.93448 , 21 , 21 , 0
ScoreForHonestReporter: , 734 , H_UR_733 , 0.2328 , 1 , 1 , 0
ScoreForHonestReporter: , 735 , H_UR_734 , 2.34367 , 10 , 10 , 0
ScoreForHonestReporter: , 736 , H_UR_735 , 0 , 0 , 0 , 0
ScoreForHonestReporter: , 737 , H_UR_736 , 2.11098 , 9 , 9 , 0
ScoreForHonestReporter: , 738 , H_UR_737 , 0.235654 , 1 , 1 , 0
ScoreForHonestReporter: , 739 , H_UR_738 , 3.75975 , 16 , 16 , 0
ScoreForHonestReporter: , 740 , H_UR_739 , 0 , 0 , 0 , 0
ScoreForHonestReporter: , 741 , H_UR_740 , 3.05081 , 13 , 13 , 0
ScoreForHonestReporter: , 742 , H_UR_741 , 3.76121 , 16 , 16 , 0
ScoreForHonestReporter: , 743 , H_UR_742 , 0 , 0 , 0 , 0
ScoreForHonestReporter: , 744 , H_UR_743 , 0 , 0 , 0 , 0
ScoreForHonestReporter: , 745 , H_UR_744 , 9.07246 , 39 , 39 , 0
ScoreForHonestReporter: , 746 , H_UR_745 , 1.16992 , 5 , 5 , 0
ScoreForHonestReporter: , 747 , H_UR_746 , 0.935922 , 4 , 4 , 0
ScoreForHonestReporter: , 748 , H_UR_747 , 0 , 0 , 0 , 0
ScoreForHonestReporter: , 749 , H_UR_748 , 0.468453 , 2 , 2 , 0
ScoreForHonestReporter: , 750 , H_UR_749 , 3.28287 , 14 , 14 , 0
ScoreForHonestReporter: , 751 , H_UR_750 , 0 , 0 , 0 , 0
ScoreForHonestReporter: , 752 , H_UR_751 , 0 , 0 , 0 , 0
ScoreForHonestReporter: , 753 , H_UR_752 , 3.75804 , 16 , 16 , 0
ScoreForHonestReporter: , 754 , H_UR_753 , 0 , 0 , 0 , 0
ScoreForHonestReporter: , 755 , H_UR_754 , 5.1584 , 22 , 22 , 0
ScoreForHonestReporter: , 756 , H_UR_755 , 0 , 0 , 0 , 0
ScoreForHonestReporter: , 757 , H_UR_756 , 4.46339 , 19 , 19 , 0
ScoreForHonestReporter: , 758 , H_UR_757 , 0 , 0 , 0 , 0
ScoreForHonestReporter: , 759 , H_UR_758 , 2.34796 , 10 , 10 , 0
ScoreForHonestReporter: , 760 , H_UR_759 , 0 , 0 , 0 , 0
ScoreForHonestReporter: , 761 , H_UR_760 , 3.05142 , 13 , 13 , 0
ScoreForHonestReporter: , 762 , H_UR_761 , 2.11204 , 9 , 9 , 0
ScoreForHonestReporter: , 763 , H_UR_762 , 1.40459 , 6 , 6 , 0
ScoreForHonestReporter: , 764 , H_UR_763 , 0.4663 , 2 , 2 , 0
ScoreForHonestReporter: , 765 , H_UR_764 , 5.16644 , 22 , 22 , 0
ScoreForHonestReporter: , 766 , H_UR_765 , 0.235654 , 1 , 1 , 0
ScoreForHonestReporter: , 767 , H_UR_766 , 0 , 0 , 0 , 0
ScoreForHonestReporter: , 768 , H_UR_767 , 2.11252 , 9 , 9 , 0
ScoreForHonestReporter: , 769 , H_UR_768 , 0 , 0 , 0 , 0
ScoreForHonestReporter: , 770 , H_UR_769 , 0.700543 , 3 , 3 , 0
ScoreForHonestReporter: , 771 , H_UR_770 , 0 , 0 , 0 , 0
ScoreForHonestReporter: , 772 , H_UR_771 , 5.64642 , 24 , 24 , 0
ScoreForHonestReporter: , 773 , H_UR_772 , 3.05206 , 13 , 13 , 0
ScoreForHonestReporter: , 774 , H_UR_773 , 0 , 0 , 0 , 0
ScoreForHonestReporter: , 775 , H_UR_774 , 2.1078 , 9 , 9 , 0
ScoreForHonestReporter: , 776 , H_UR_775 , 1.63989 , 7 , 7 , 0
ScoreForHonestReporter: , 777 , H_UR_776 , 0.937731 , 4 , 4 , 0
ScoreForHonestReporter: , 778 , H_UR_777 , 5.40599 , 23 , 23 , 0
ScoreForHonestReporter: , 779 , H_UR_778 , 2.5832 , 11 , 11 , 0
ScoreForHonestReporter: , 780 , H_UR_779 , 0 , 0 , 0 , 0
ScoreForHonestReporter: , 781 , H_UR_780 , 0 , 0 , 0 , 0
ScoreForHonestReporter: , 782 , H_UR_781 , 3.52806 , 15 , 15 , 0
ScoreForHonestReporter: , 783 , H_UR_782 , 0.465599 , 2 , 2 , 0
ScoreForHonestReporter: , 784 , H_UR_783 , 5.63951 , 24 , 24 , 0
ScoreForHonestReporter: , 785 , H_UR_784 , 3.51638 , 15 , 15 , 0
ScoreForHonestReporter: , 786 , H_UR_785 , 0 , 0 , 0 , 0
ScoreForHonestReporter: , 787 , H_UR_786 , 0.2328 , 1 , 1 , 0
ScoreForHonestReporter: , 788 , H_UR_787 , 0 , 0 , 0 , 0
ScoreForHonestReporter: , 789 , H_UR_788 , 5.64066 , 24 , 24 , 0
ScoreForHonestReporter: , 790 , H_UR_789 , 0.468453 , 2 , 2 , 0
ScoreForHonestReporter: , 791 , H_UR_790 , 1.87441 , 8 , 8 , 0
ScoreForHonestReporter: , 792 , H_UR_791 , 0.2328 , 1 , 1 , 0
ScoreForHonestReporter: , 793 , H_UR_792 , 0 , 0 , 0 , 0
ScoreForHonestReporter: , 794 , H_UR_793 , 0 , 0 , 0 , 0
ScoreForHonestReporter: , 795 , H_UR_794 , 2.81428 , 12 , 12 , 0
ScoreForHonestReporter: , 796 , H_UR_795 , 0.699115 , 3 , 3 , 0
ScoreForHonestReporter: , 797 , H_UR_796 , 6.94884 , 30 , 30 , 0
ScoreForHonestReporter: , 798 , H_UR_797 , 0 , 0 , 0 , 0
ScoreForHonestReporter: , 799 , H_UR_798 , 0 , 0 , 0 , 0
ScoreForHonestReporter: , 800 , H_UR_799 , 0.4663 , 2 , 2 , 0
